Level G Quiz words		
part	n.	部分
happen	v.	发生
different	adj.	不同的
why	adv.	为什么
take place	v.	发生
describe	v.	描述
mean	v.	意味着
sentence	n.	句子
main idea	n.	中心思想
detail	n.	细节
author's purpose	n.	作者意图
last step	n.	最后一步
reader	n.	读者
cause	v.	造成
information	n.	信息
caption	n.	说明文字
page	n.	页码
mostly	adv.	主要的
character	n.	角色
problem	n.	问题
event	n.	事件
story	n.	故事
end	n.	结尾
example	n.	例子
alike	adj.	相似的
table of contents	n.	目录
passage	n.	文章
similar	adj.	相似的
the following	adj.	接下来的
word	n.	单词
fact	n.	事实
reason	n.	原因
