The Four Seasons		
are	v.	是
in	prep.	在...里面
the	art.	这个
spring	n.	春天
summer	n.	夏天
winter	n.	冬天
fall	n.	秋天
Happy Birthday Snag!		
do	v.	做
yes	adv.	是的
you	pron.	你
balloons	n.	气球（复数形式）
birthday	n.	生日
candles	n.	蜡烛（复数形式）
presents	n.	礼物（复数形式）
Getting ready for school		
some	adj.	一些的
they	pron.	他们
to	prep.	去
backpacks	n.	背包（复数形式）
breakfast	n.	早餐
everywhere	pron.	到处
paper	n.	纸
Hooray for the Farmer's Market!		
can	modal.	能够
I	pron.	我
the	art.	这个
artist	n.	艺术家
baker	n.	面包师
band	n.	乐队
gardener	n.	花匠
market	n.	市场
Goodbye Snow		
removed	v.	移开
shovel	n.	铲子
snow dumps	n.	清雪车（复数形式）
snow melter	n.	融雪器
snowblower	n.	吹雪机
snowplow	n.	扫雪机
away	adv.	离开
be	v.	是
can	modal.	能够
Hug		
away	adv.	离开
gave	v.	给
hug	n.	拥抱
very	adv.	非常
enormous	adj.	巨大的
giant	adj.	巨大的
huge	adj.	极大的
miserable	adj.	痛苦的
rotten	adj.	不适的
How Many Teeth		
different	adj.	不同的
fangs	n.	牙根（复数形式）
numbers	n.	数字（复数形式）
oppossum	n.	负鼠
teeth	n.	牙齿
vampire bat	n.	吸血蝙蝠
can	modal.	能够
have	v.	有
many	adj.	许多的
Kaden's Kwanzaa		
African American	adj.	非洲裔美国的
celebrates	v.	庆祝（第三人称单数）
crafts	n.	工艺品
feast	n.	盛宴
heritage	n.	遗产
Kwanzaa	n.	匡扎节
is	v.	是
my	pron.	我的
we	pron.	我们
I AmThankful		
curly	adj.	卷曲的
music	n.	音乐
show	v.	展示
thankful	adj.	感谢的
trains	n.	火车（复数形式）
trips	n.	旅行（复数形式）
for	prep.	为了
her	pron.	她的
his	pron.	他的
Lost And Found		
guard	n.	保安
lost	adj.	丢失
safe	adj.	安全的
salesperson	n.	销售员
stranger	n.	陌生人
uniform	n.	制服
am	v.	是
my	pron.	我的
what	adj.	什么
