Barack Obama		
cultures	n.	文化
elected	v.	选举
government	n.	政府
lawyer	n.	律师
message	n.	信息
speech	n.	演讲
moved	v.	搬家
peace	n.	和平
president	n.	总统
Community Government		
community	n.	社区
council	n.	委员会
departments	n.	部门
election	n.	选举
goverment	n.	政府
mayor	n.	市长
vote	v.	投票
Emergency 	n.	紧急情况
hospital	n.	医院
judge	n.	法官
court	n.	法院
punishment 	n.	惩罚
Anna and the magic coat		
breeze	n.	微风
cupcakes	n.	纸杯蛋糕
magic	adj.	有魔力的
picnics	n.	野餐
swirled	v.	盘绕；打旋
weather	n.	天气
murmured	v.	呐呐地说
Oma	n.	奶奶
Opa	n.	爷爷
Grounded to Earth		
controls 	n.	控制设备
powerful 	adj.	强大的；强有力的
blasters	n.	炸药
lesson	n.	教训
suit	n.	一套衣服
teleported	v.	传输，传送
take over	v.	接管，掌管
alien	n.	外星人
It's about time		
candle clock	n.	蜡烛钟
cuckoo	n.	布谷鸟
grandfather clock	n.	有摆的落地大座钟
shadow clock	n.	影子钟
sundial	n.	日晷
analog 	adj.	(钟表)有长短针的
digital 	adj.	数字的
electricity 	n.	电
water clock	n.	水钟
probably 	adv.	可能
position 	n.	位置
rose 	v.	升起（rise 的过去式）
discovered 	v.	发现
container 	n.	容器
steadily 	adv.	稳定地
Flying kites		
against	prep.	靠；倚
caught	v.	抓住
kite	n.	风筝
speck	n.	小点
trouble	n.	麻烦
swept 	v.	扫（sweep的过去式）
string 	n.	线
sight	n.	视线
Ships and Boats 		
engines	n.	发动机
explorers	n.	探险家
frames	n.	框架
goods	n.	货物
propellers	n.	螺旋辊
sails	n.	船帆
broad 	adj.	宽的
oar	n.	桨；橹
paddles	n.	船桨
poles	n.	竹竿
submarines	n.	潜水艇
Slithery and Slimy		
amphibians	n.	两栖动物
backbones	n.	脊柱
endangered	adj.	濒临灭绝的
reptiles	n.	爬行动物
scales	n.	鳞片
venomous	adj.	有毒的
extinct	adj.	灭绝的
polluted	adj.	被污染的
relatives	n.	亲缘动物
slithery	adj.	滑的
slimy	adj.	粘的
The empty pot		
boiled	v.	煮
emperor	n.	皇帝
empty	adj.	空的
honest	adj.	诚实的
pleased	adj.	高兴的
sprout	v.	发芽
become	v.	成为
through	prep	通过
use	v.	使用
Jack-o’-Lantern		
carved	v.	雕刻
cursed	v.	诅咒
decorate	v.	装饰
design	n.	设计
display	n.	陈列, 展览
stingy	adj.	小气的,吝啬的
forever	adv.	永远
record	n.	记录
without	prep	没有
Tarantula		
fangs	n.	尖牙，毒牙
harmless	adj.	无害的
prey	n.	猎物
sense	v.	感觉
spider	n.	蜘蛛
venom	n.	毒液
splits 	v.	裂开
stiff 	adj.	坚硬的
sting 	v.	刺
enemies 	n.	敌人
drags 	v.	拖走
tasty 	adj.	美味的
threat 	n.	威胁
Hugs for Daddy		
cymbals	n.	cymbals
instruments	n.	乐器
military	n.	军队
salute	n.	敬礼
tracing	v.	摹图;描图
uniform	n.	制服
