Say Cheese		
bubbles	v.	起泡（第三人称单数）
burner	n.	炉子
curd	n.	凝乳
drain	v.	排空
strainer	n.	滤网
whey	n.	乳水
help	v.	帮助
make	v.	使得
put	v.	放置
Tiny Tugboat		
are	v.	是
other	adj.	其他的
out	adv.	外面
pulls	v.	拉（第三人称单数）
stuck	adj.	无法移动的
submarine	n.	潜水艇
tugboat	n.	拖船
Sew Who		
beak	n.	喙
felt	n.	毛毡
owl	n.	猫头鹰
pin	v.	别住
sew	v.	缝
stuffing	n.	填充物
from	prep.	从...
two	num.	两个
under	prep.	在...下面
Too Much Work		
he	pron.	他
his	pron.	他的
makes	v.	使得（第三人称单数）
fluffs	v.	抖松（第三人称单数）
stripes	n.	条纹（复数形式）
ready	adj.	准备好的
Shapes in Tide Pools		
has	v.	有（第三人称单数）
like	v.	喜欢
this	pron.	这个
mussel	n.	蚌
oval	n.	椭圆形
shores	n.	岸（复数形式）
tide	n.	潮汐
Try, Try Again		
failed	v.	失败
monkey bars	n.	攀爬架（复数形式）
muscles	n.	肌肉（复数形式）
stronger	adj.	更强壮的
studied	v.	学习（过去式）
tried	v.	尝试（过去式）
but	conj.	但是
little	adj.	小的
make	v.	使得
Shoes Men Wear		
are	v.	是
in	prep.	在..里面
them	pron.	他们
cleats	n.	防滑鞋（复数形式）
flip-flops	n.	人字拖（复数形式）
slippers	n.	拖鞋（复数形式）
sneakers	n.	运动鞋（复数形式）
boots	n.	靴子（复数形式）
Wake Up Bear!		
are	v.	是
is	v.	是
she	pron.	她
awake	adj.	醒来的
den	n.	兽穴
sleepy	adj.	困倦的
Shoes Women Wear		
are	v.	是
in	prep.	在..里面
them	pron.	他们
cleats	n.	防滑鞋（复数形式）
flip-flops	n.	人字拖（复数形式）
slippers	n.	拖鞋（复数形式）
sneakers	n.	运动鞋（复数形式）
boots	n.	靴子（复数形式）
Walk Awhile		
awhile	adv.	一会儿
ready	adj.	准备好的
together	adv.	一起
wheat	n.	小麦
whiskers	n.	口哨声（复数形式）
whistle	v.	胡须
they	pron.	他们
to	prep.	去
want	v.	想要
