Strange Plants 		
attract 	v.	吸引
branches	n.	树枝
digests	v.	消化
moisture	n.	水分
parasite	n.	寄生植物
plants	n.	植物
another 	adj.	另外的
instead	adv.	代替
noise	n.	噪音
garbage	n.	垃圾；废物
solid	adj.	坚硬的
shrubs	n.	灌木
spikes 	n.	此
powder 	n.	花粉
cracks	n.	裂缝
protect	v.	保护
The Grand Canyon 		
dangerous 	adj.	危险的
erosion	n.	(河流、气候等的)侵蚀
national park 	n.	国家公园
protected	adj.	受保护的
sediment	n.	沉积物
tribes	n.	部落
area 	n.	地区
became	v.	变成，成为
fact	n.	事实
history	n.	历史
through	prep.	穿过，通过
usually	adv.	通常
How Zebras Got Their Stripes 		
appreciated	v.	赞赏
fooled	v.	愚弄；欺骗
impatient	adj.	没有耐心的
problem	n.	问题
roam	v.	漫游，漫步
relax	v.	放松
graze	v.	吃草
wise	adj.	聪慧的
stream	n.	小溪
suddenly 	adv.	突然
pleaded	v.	恳求，请求
Where We Get Energy 		
electricity 	n.	电
energy	n.	能量
fuel	n.	燃料
generator	n.	发电机
natural gas	n.	天然气
solar cells	n.	太阳能电池
resource 	n.	资源
oil	n.	石油; 原油
gasoline 	n.	汽油
pump 	v.	用泵抽取
power plant	n.	发电厂
coal 	n.	煤
limited 	adj.	有限的
replaced 	v.	替代
Abigail Adams 		
causes	n.	思想
colonies	n.	殖民地
equal rights	n.	平等权
First Lady 	n.	第一夫人
independent	adj.	独立的
respected	v.	尊重
Great Britain 	n.	英国
treat 	v.	对待
taxes 	n.	税
common	adj.	普通的
soldiers 	n.	军人
I Fly Hot-Air Balloons 		
nylon	n.	尼龙（一种布料）
fuel	n.	燃料
oxygen	n.	氧气
satellites	n.	卫星
scenery	n.	风景
pilot	n.	飞行员
 steer 	v.	驾驶
burner 	n.	燃烧器
radio signals 	n.	无线电讯号
heights 	n.	高度
temperature 	n.	温度
Animals, Animals 		
elk	n.	麋鹿
giraffes	n.	长颈鹿
hippopotamus	n.	河马
kangaroo	n.	袋鼠
polar bears	n.	北极熊
snow leopards	n.	雪豹
zebra	n.	斑马
antlers 	n.	鹿角
burrow	n.	洞穴
coat	n.	皮毛
grasslands	n.	草地
manes	n.	鬃毛
pouch	n.	育儿袋
savannas	n.	 热带稀树草原
trunks	n.	象鼻
The Butterfly Life Cycle		
butterfly 	n.	蝴蝶
life cycle 	n.	生命周期
mate 	n.	配偶
pupa	n.	蛹
scales	n.	鳞片
stages	n.	阶段
splits 	v.	裂开
caterpillar 	n.	毛毛虫
prepare	v.	准备
bright	adj.	明亮的
energy 	n.	能量
liquid 	n.	液体
search	v.	寻找
Leap! A Salmon’s Story		
current 	n.	水流
downstream	adv.	顺流而下
predators	n.	捕食者
rapids	n.	湍流；急流
spawn	v.	产卵
upstream	adv.	逆流而上
fry 	n.	鱼苗
mighty 	adj.	有力的，充满力量的
Día de los Muertos 		
altars 	n.	祭坛
celebrate	v.	庆祝
cemetery	n.	墓地
decorate	v.	装饰
remember	v.	缅怀
traditions	n.	传统
parade 	n.	游行
masks	n.	面具
skulls 	n.	头骨
memories	n.	回忆
Dr. King’s Memorial 		
laws	n.	法律
memorial	n.	纪念碑
peaceful	adj.	和平的
protested	v.	抗议
racism	n.	种族主义，种族歧视
separate	adj.	分开的
different	adj.	不同的
remember	v.	纪念
same	adj.	相同的
Brainstorm Bear 		
bouncing 	v.	弹跳
brainstorm	v.	头脑风暴
distance	n.	距离
trail	n.	路径
trampoline	n.	蹦床
yard sale	n.	庭院旧货出售
probably	adv.	可能
suggest	v.	建议
cancel 	v.	取消
ruined	v.	毁坏
tulips 	n.	郁金香
promised 	v.	答应，承诺