Amelia Earhart A Legend in Flight		
accomplishments	n.	成就（名词复数）
disappeared	v.	消失（过去式）
fatigue	n.	（金属或木材）疲劳
legend	n.	传奇
navigator	n.	领航员
pilots	n.	驾驶员（名词复数）
bloomers	n.	灯笼裤
instruments	n.	仪器（名词复数）
tailspin	n.	混乱
raft	n.	橡皮艇，木筏
control	n.	控制
publicist	n.	宣传员
dazzled	v.	使眼花（过去式）
The Buffalo Soldiers		
bravery	n.	勇敢
contracts	n.	合约（名词复数）
fierce	adj.	凶残的
regiments	n.	军团（名词复数）
reservations	n.	保留地（名词复数）
stagecoaches	n.	马车（名词复数）
command	v.	命令
discrimination	n.	歧视
expand	v.	扩大
enslaved	v.	奴役（过去式）
cavalry	n.	骑兵队
regardless	adv.	不顾
innocent	adj.	无罪的
Book1 The Kid Who Couldn't Save		
compound	v.	以复利计算支付
corral	v.	把...集中在一起
interest	n.	利息
objected	v.	反对
savings account	n.	存款账户
upgraded	v.	提升级别
technically	adv.	根据确切意义地
torture	n.	痛苦
variety	n.	品种
allowance	n.	零花钱
disgusting	adj.	让人无法接受的
confound	v.	挫败
Book2 Who Likes Lemonade	
artisanal	adj.	手工业
boomed	v.	暴涨
discount	n.	打折
organic	adj.	有机的
profit margin	n.	利润率
season	n.	时节
donated	v.	捐赠
influx	n.	涌入
triumphantly	adv.	得意洋洋地
awesome	adj.	令人惊叹的
pucker	v.	撅起
quality	n.	品质
announced	v.	宣布
Cesar Chavez Migrant Hero		
boycott	v.	拒绝购买
conditions	n.	情况
labor union	n.	工会
migrant	n.	移民
organizing	v.	组织
strike	n.	罢工
cheated	v.	欺骗
immigrants	n.	侨民
persuasive	adj.	令人信服的
social justice	n.	社会公平
toiled	v.	劳动
wages	n.	工资
China		
civilizations	n.	文明
Communist government	n.	共产主义政府
culture	n.	文化
economy	n.	经济
Mandarin	n.	普通话
paddies	n.	水稻
chopsticks	n.	筷子
historians	n.	历史学家
utensils	n.	餐具
ethnic	adj.	民族的
incredible	adj.	难以置信的
abacus	n.	算盘
manufacturing	n.	制造业
Building Tunnels		
collapse	v.	坍塌
explosives	n.	炸药
line	v.	填塞
sealed	v.	封闭
stable	adj.	稳定的
trench	n.	渠
boring	v.	钻孔
dynamite	n.	甘油炸药
engineers	n.	工程师
muck	n.	湿粪
obstacles	n.	阻碍
technology	n.	科技
The Ant in the Photograph		
admired	v.	欣赏（过去式）
camera	n.	照相机
photograph	n.	照片
recycled	v.	反复利用（过去式）
ruined	adj.	损毁的
sculpture	n.	雕像
concentrate	v.	集中注意力
conversation	n.	交谈
crash	n.	崩塌
wastebasket	n.	废纸篓
shrug	v.	耸肩
Coral Reefs		
bleaching	n.	漂白
coral reefs	n.	珊瑚礁
dissolve	v.	溶解
fragile	adj.	易碎的
skeletons	n.	骨架
tropical	adj.	热带的
carbon dioxide	n.	二氧化碳
erosion	n.	侵蚀
tsunami	n.	海啸
tentacles	n.	触手
algae	n.	海藻
starve	v.	饿死
Komodo Dragons Giant Reptiles		
adaptation	n.	适应
ambush	v.	伏击
bacteria	n.	细菌
conservation	n.	保护区
muscular	adj.	强健的
organ	n.	器官
poachers	n.	偷猎者
reptiles	n.	爬行动物
venom	n.	毒液
harsher	adj.	更恶劣的
burrow	n.	洞穴
overpower	v.	打败
particle	n.	颗粒
Landfills What a Load of Garbage!		
biodegradable	adj.	可生物降解的
groundwater	n.	地下水
landfills	n.	垃圾填埋洼地（名词复数）
pollute	v.	污染
toxic	adj.	有毒的
treated	v.	处理（过去式）
elements	n.	恶劣天气
methane	n.	甲烷
organic	adj.	有机的
pyramids	n.	金字塔
population	n.	人口
smash	v.	粉碎
explosions	n.	爆炸（名词复数）
Morty and the Walkathon		
lap	n.	一圈
pace	n.	步伐
partnered	v.	做...的伙伴（过去式）
pledge	v.	保证
theme	n.	主题
walkathon	n.	步行马拉松
bullhorn	n.	扩音器
fanfare	n.	号角花彩
hobbled	v.	蹒跚（过去式）
team	n.	队
declared	v.	宣布
necessarily	adv.	必然地
The Hollow		
expression	n.	表情
freak	v.	使...焦虑不适
ghost	n.	鬼魂
Halloween	n.	万圣节
haunted	adj.	有鬼魂的
terrified	adj.	害怕的
gnarled	adj.	扭曲的
tatters	n.	破布烂衣
trudging	v.	沉重地跋涉
skeletal	adj.	骨骼的
insist	v.	坚持
creak	n.	咯吱声
thornbush	n.	刺丛
Lost Cities		
ancient	adj.	古老的
archaeologist	n.	考古学家
artifacts	n.	史前古器物
preserved	v.	保护（过去式）
settlements	n.	居住地
uninhabited	adj.	无人居住的
sanctuary	n.	避难所
siege	n.	围攻
terraces	n.	阶地
location	n.	位置
religious	adj.	宗教的
discovery	n.	发现
The Cave of the Lost		
creep	v.	缓慢行进
echoes	v.	回响
figure	n.	体型
fork	n.	岔路
gorge	n.	峡谷
passage	n.	通路
bolts	v.	逃走
chamber	n.	卧室
encounter	v.	遇到
darkness	n.	黑暗
mysterious	adj.	神秘的
disappeared	v.	消失（过去式）
exclaim	v.	惊叫
Famous First Ladies		
assassinated	v.	暗杀
discrimination	n.	歧视
humanitarian	n.	人道主义的
immunizations	n.	免疫接种
influential	adj.	有影响的
polio	n.	小儿麻痹症
enrich	v.	丰富
hardship	n.	困苦
involvement	n.	参与
admiration	n.	钦佩
