Clouds		
a	art.	一个
do	v.	做
I	pron.	我
look	v.	看
see	v.	看见
the	art.	这个
what	pron.	什么
you	pron.	你
darker	adj.	更暗的
fuzzy	adj.	毛茸茸的
jumbo	adj.	巨大的
puffy	adj.	蓬松的
creamy	adj.	奶油般的
Pick a Pie		
blackberries	n.	黑莓（复数形式）
cups	n.	茶杯（复数形式）
enough	adv.	足够
picked	v.	采摘（过去式）
pie	n.	派
plenty	n.	大量
have	v.	有
made	v.	制作（过去式）
we	pron.	我们
How do they swim		
bodies	n.	身体（复数形式）
fins	n.	鱼鳍（复数形式）
flippers	n.	背鳍（复数形式）
paws	n.	爪子（复数形式）
swim	v.	游泳
tails	n.	尾巴（复数形式）
can	modal.	能够
their	pron.	他们的
they	pron.	他们
The Mitten		
after	prep.	在...之后
he	pron.	他
into	prep.	进入到
she	pron.	她
too	adv.	也
was	v.	是
with	prep.	和
mitten	n.	手套
squash	v.	塞进
squeeze	v.	挤入
squish	v.	挤进
Country Places		
is	v.	是
this	pron.	这个
what	pron.	什么
corral	n.	畜栏
farmhouse	n.	农舍
orchard	n.	果园
shed	n.	小屋
Pillow Fort Passward		
anyway	adv.	无论如何
cookies	n.	饼干（复数形式）
know	v.	知道
password	n.	密码
pillow fort	n.	枕头堡
wanted	v.	想要（过去式）
come	v.	来到
he	pron.	他
know	v.	知道
I Count 100 Things		
can	modal.	能够
make	v.	制作
what	pron.	什么
count	v.	计数
gumdrops	n.	橡皮糖（复数形式）
igloo	n.	冰屋
marshmallow	n.	棉花糖
paperclips	n.	别针（复数形式）
My First Class Play		
acting	v.	表演（现在分词）
costume	n.	戏服
lines	n.	台词（复数形式）
nervous	adj.	焦虑的
props	n.	舞台道具（复数形式）
stage	n.	舞台
am	v.	是
my	pron.	我的
what	pron.	什么
Hobbies		
like	v.	喜欢
some	adj.	一些的
they	pron.	他们
collecting	v.	收集（现在分词）
create	v.	创造
relax	v.	放松
writing	v.	书写（现在分词）
Shave It Off		
ago	adv.	之前
beard	n.	胡子
hairy	adj.	浓密的
shave	v.	刮胡子
smooth	adj.	光滑的
wild	adj.	野生的
he	pron.	他
like	prep.	像
said	v.	说(过去式）
Imagine the Beach		
crashing	adj.	哗啦一声的
dive	v.	潜水
imagine	v.	想象
rough	adj.	粗糙的
salty	adj.	咸的
sense	n.	感觉
can	modal.	能够
what	pron.	什么
you	pron.	你
Silent E		
how	adv.	如何
into	prep.	进入到
what	pron.	什么
change	v.	改变
sound	v.	听起来
mean	v.	意思是
silent	adj.	沉默的
Insect Wings		
clear	adj.	透明的
covers	n.	遮盖（复数形式）
insects	n.	昆虫（复数形式）
spotted	adj.	有斑点的
wasp	n.	黄蜂
wings	n.	翅膀（复数形式）
fly	v.	飞
has	v.	有（第三人称单数）
many	adj.	许多的
Sky High		
all	pron.	所有的
goes	v.	去（第三人称单数）
on	prep.	在...之上
up	adv.	向上
bumpy	adj.	崎岖不平的
gorilla	n.	猩猩
mossy	adj.	长满苔藓的
Less Than		
compare	v.	比较
count	v.	数一数
fewer	adj.	更少的
less than	adj.	少于
numbers	n.	数量（复数形式）
total	n.	总计
blue	adj.	蓝色的
has	v.	有（第三人称单数）
red	adj.	红色的
Tadpole Teasing		
are	v.	是
said	v.	说（过去式）
the	art.	这个
grew	v.	成长（过去式）
odd	adj.	奇怪的
strange	adj.	奇特的
tadpole	adj.	蝌蚪
Let's Make a Bird Feeder		
bird feeder	n.	喂鸟器
birdseed	n.	鸟食
dried	adj.	脱水的
fruit	n.	水果
hang	v.	悬挂
slices	n.	薄片（复数形式）
make	v.	制作
put	v.	放置
we	pron.	我们
These Bees		
birdhouse	n.	鸟窝
bus stop	n.	公交站
home	n.	家
log	n.	圆木
mailbox	n.	邮箱
need	v.	需要
good	adj.	好的
look	v.	看
no	int.	不
Mud Balls		
and	conj.	和
in	prep.	在...里面
we	pron.	我们
dry	adj.	干燥的
mix	v.	混合
mud	n.	泥土
sand	n.	沙子
scoop	v.	挖出
shape	v.	塑形
My New City		
city	n.	城市
different	adj.	不同的
freeway	n.	高速公路
moved	v.	移动（过去式）
stores	n.	商店（复数形式）
subway	n.	地铁
down	adv.	向下
now	adv.	现在
ride	v.	搭乘
Reindeer Are Real		
born	adj.	与生俱来的
real	adj.	真实的
reindeer	n.	驯鹿
sleds	n.	雪橇（复数形式）
travel	v.	行进
weigh	v.	称重
all	pron.	所有的
are	v.	是
walk	v.	走路
Polly Gets Out		
over	prep.	超过
saw	v.	看到（过去式）
she	pron.	她
cage	n.	笼子
children	n.	孩子们（复数形式）
flew	v.	飞（过去式）
path	n.	小路
playground	n.	操场
safe	adj.	安全的
River Otters		
amazing	adj.	神奇的
breath	n.	呼吸
catching	n.	捕食
fur	n.	皮毛
river otters	n.	水獭（复数形式）
swimming	n.	游泳
all	pron.	所有的
good	adj.	好的
have	v.	有
The Sky Is Falling		
is	v.	是
not	adv.	不
squirrel	n.	松鼠
falling	v.	倒塌（现在分词）
nut	n.	坚果
hits	v.	击中（第三人称单数）
Senses		
I	pron.	我
my	pron.	我的
use	v.	使用
smell	v.	闻起来
hear	v.	听到
senses	v.	感觉（第三人称单数）
taste	v.	品尝
touch	v.	触摸
Stone Soup		
and	conj.	和
had	v.	有（过去式）
some	adj.	一些的
they	pron.	他们
brought	v.	带来（过去式）
feast	n.	盛宴
hungry	adj.	饥饿的
soup	n.	汤
Swamps		
clean	adj.	干净的
fresh water	n.	淡水
healthy	adj.	健康的
salt water	n.	咸水
soil	n.	土壤
swamp	n.	湿地
can	modal.	能够
help	v.	帮助
many	adj.	许多的
Tootsie Can Talk		
birthday	n.	生日
cake	n.	蛋糕
good	adj.	好的
make	v.	制作
nothing	pron.	没什么
sweet	adj.	甜的
am	v.	是
girl	n.	女孩
said	v.	说（过去式）
The Team		
a	art.	一个
has	v.	有（第三人称单数）
have	v.	有
is	v.	是
very	adv.	非常
baseball	n.	棒球
batter	n.	击球员
catcher	n.	接球手
pitcher	n.	投手
players	n.	运动员（复数形式）
Under the Rock		
grub	n.	毛毛虫
silky	adj.	吐丝的
slow	adj.	慢的
smooth	adj.	光滑的
surprises	n.	惊喜（复数形式）
wiggly	adj.	蠕动的
find	v.	找到
may	modal.	或许
you	pron.	你
