Arctic Animals		
antlers	n.	鹿角（复数形式）
Arctic	n.	极地
caribou	n.	北美驯鹿
hunt	v.	捕猎
orcas	n.	虎鲸（复数形式）
packs	n.	群（复数形式）
cold	adj.	寒冷的
live	v.	居住
they	pron.	他们
Bear And Kangaroo		
can	modal.	能够
make	v.	使得
said	v.	说（过去式）
catch	v.	抓住
climb	v.	爬
eat	v.	吃
hop	v.	跳
juggle	v.	玩杂耍
lift	v.	举起
At the Rodeo		
next	adv.	然后
what	pron.	什么
barrels	n.	桶（复数形式）
belt buckles	n.	皮带扣（复数形式）
broncos	n.	野马（复数形式）
rodeo	n.	牛仔竞技比赛
The Boy Who Cried Wolf!		
again	adv.	再一次
ran	v.	跑步（过去式）
there	adv.	那里
liars	n.	说谎者（复数形式）
trick	n.	骗局
truth	n.	事实
cried	v.	大喊（过去式）
Calming Down		
can	modal.	能够
down	adv.	向下
to	prep.	去
you	pron.	你
angry	adj.	生气的
breathe	v.	呼吸
calm	v.	冷静
feelings	n.	感情（复数形式）
The Brothers G		
gel	n.	发胶
goblins	n.	小矮人（复数形式）
goggles	n.	护目镜（复数形式）
gorgeous	adj.	华丽的
hard	adj.	坚硬的
soft	adj.	柔软的
like	v.	喜欢
says	v.	说（第三人称单数）
they	pron.	他们
Caring for Earth		
difference	n.	不同
Earth	n.	地球
electricity	n.	电能
recycle	v.	循环
reuse	v.	再利用
tend	v.	照料
for	prep.	为了
we	pron.	我们
when	adv.	当...时候
Carlos's First Halloween		
look	v.	看
our	pron.	我们的
us	pron.	我们
building	n.	建筑物
costumes	n.	服装（复数形式）
ghost	n.	幽灵
pirate	n.	海盗
scared	adj.	害怕的
City Animals		
live	v.	居住
they	pron.	他们
geese	n.	鹅（复数形式）
hawks	n.	鹰（复数形式）
opossums	n.	负鼠（复数形式）
pigeons	n.	鸽子（复数形式）
raccoons	n.	浣熊（复数形式）
The Class Pet		
feed	v.	喂养
help	v.	帮助
problems	n.	问题（复数形式）
solve	v.	解决
turn	n.	机会
wanted	v.	想要（过去式）
can	modal.	能够
said	v.	说（过去式）
the	art.	这个
