What Lives in This Hole 		
burrows	n.	洞穴
naked mole rats	n.	裸鼹鼠
puffins	n.	角嘴海雀
salamander	n.	火蜥蜴
tunnels	n.	地下通道
wombat	n.	袋熊
blog	n.	博客
claws	n.	爪子
webbed feet	n.	蹼足
To the Pumpkin Patch 		
crooked	adj.	歪的，畸形的
disobey	v.	不服从，忤逆
float	v.	漂浮
patch	n.	小块土地
pumpkins	n.	南瓜
stream	n.	小溪
Yellowstone A Place of Wild Wonders 		
explorers	n.	探险家，探索者
hot spot	n.	热点
national park	n.	国家公园
native	n.	原住民
protected	adj.	受保护的
wildlife	n.	野生动植物
Hawaii Volcanoes National Park 		
active	adj.	活跃的
erupted	v.	喷发
lava	n.	熔岩
national park	n.	国家公园
protected	adj.	受保护的
rainforest	n.	热带雨林
another	adj.	另一个
area	n.	地区，区域
through	prep.	穿过
The Leprechaun Trap 		
bait	n.	诱饵
career	n.	事业
disprove	v.	证明…是虚假的
exist	v.	存在
experiments	n.	实验
scientist	n.	科学家
conduct	v.	开展，进行
consider	v.	考虑，认为
prove	v.	证明
I Collect That		
alike	adj.	相似的，相同的
collection	n.	收藏品
hobby	n.	爱好
keepsake	n.	纪念品
popular	adj.	受欢迎的
type	n.	类型
another	adj.	另一个
same	adj.	相同的
usually	adj.	通常
Julia’s Castle 		
brick	n.	砖头
castle	n.	城堡
creation	n.	创造物
destroyed	v.	毁坏，毁灭
perfect	adj.	完美的
tower	n.	塔
forever	adv.	永远
plan	n.	计划
protect	v.	保护
I Love City Parks 		
audience	n.	观众
elevated	adj.	高架列车
fountain	n.	喷水池
platform	n.	站台
reflection	n.	映像
theater	n.	剧院
canyon	n.	峡谷
gigantic	adj.	巨大的
millennium	n.	一千年（千禧）
uniform	n.	制服
Leah’s Lousy Day 		
calming	v.	平静
frowned	v.	皱眉
project	n.	项目，任务
scolded	v.	责骂
teased	v.	嘲笑
upset	adj.	不开心的；不安的
cause	v.	引起
show	v.	展示
though	conj.	然而
I’d Like to Be 		
discover	v.	发现
fantasy	n.	奇幻故事
galaxies	n.	银河系
possibilities	n.	可能性
stew	n.	炖菜
vet	n.	兽医
feature	v.	由…主演；特写
plot	n.	阴谋
Leap Year Birthday 		
amazement	n.	惊奇
beamed	v.	咧嘴笑
leap day	n.	闰日
leap years	n.	闰年
quarter	n.	一刻钟
time traveler	n.	时间旅行者
exactly	adv.	准确地
understand	v.	理解
usually	adv.	通常
India 		
desert	n.	沙漠
festival	n.	节日
firecrackers 	n.	爆竹
Hindu 	adj.	印度教的
mangrove 	n.	红树
monsoon 	n.	雨季
