The Festival of Lights		
candle	n.	蜡烛
festival	n.	节日
Hanukkah	n.	光明节
light	v.	点亮
middle	adj.	中间的
night	n.	夜晚
is	v.	是
on	prep.	在...上面
the	art.	这个
I Want to Be a Cat		
hunt	v.	捕猎
jump	v.	跳
movies	n.	电影
purr	v.	发出呼噜声
scratch	v.	挠
stretch	v.	伸展
can	modal.	能够
I	pron.	我
like	v.	喜欢
How Frogs Grow		
are	v.	是
have	v.	有
now	adv.	现在
froglets	n.	小青蛙
lays	v.	产卵
tadpoles	n.	蝌蚪
tails	n.	尾巴
I Wonder		
about	prep.	关于
can	modal.	能够
do	v.	做
me	pron.	我
wonder	v.	想知道
wool	n.	羊毛
lots	adv.	许多
How Many Wheels		
have	v.	有
many	adj.	许多的
some	adj.	一些
move	v.	移动
wheels	n.	车轮
Jack and Lily's Favorite Food		
are	v.	是
does	v.	做
like	v.	喜欢
different	adj.	不同的
chicken	n.	鸡肉
tuna	n.	金枪鱼
pork	n.	猪肉
Ice		
forms	v.	组成
freezes	v.	冻成
ice	n.	冰
slippery	adj.	滑的
water	n.	水
wet	adj.	潮湿的
can	modal.	能够
on	prep.	在...上面
when	adv.	在...时候
Lucy Did It		
did	v.	做
it	pron.	它
went	v.	去（过去式）
clang	n.	当当声
crash	n.	哗啦声
plop	n.	扑通
whoosh	n.	呼呼移动
Ladybugs		
eat	v.	吃
other	adj.	其他的
some	adj.	一些
insects	n.	昆虫
plants	n.	植物
spots	n.	斑点
stripes	n.	线条
Mash the Potatoes		
I	pron.	我
the	art.	这个
we	pron.	我们
boil	v.	煮
count	v.	数
mash	v.	捣碎
peels	v.	剥皮
potatoes	n.	土豆
