Motorcycles		
comfortable	adj.	舒适的
motorcycle	n.	摩托车
race	n.	比赛
track	n.	路线
traffic	n.	交通
go	v.	去
ride	v.	骑
this	pron.	这个
Scaredy Crows		
asked	v.	问（过去式）
know	v.	知道
think	v.	认为
corn	n.	玉米
farmer	n.	农民
scare	v.	恐吓
scarecrow	n.	稻草人
tractor	n.	拖拉机
Needs and Wants		
need	v.	需要
want	v.	想要
we	pron.	我们
breathe	v.	呼吸
clothing	n.	衣物
lemonade	n.	柠檬汁
pasta	n.	意大利面
storm	n.	暴风雨
Sir Suffix		
attractive	adj.	引人的
friendly	adj.	友善的
harmless	adj.	无害的
rainy	adj.	下雨的
suffix	n.	后缀
useful	adj.	有用的
can	modal.	能够
make	v.	造成
you	pron.	你
On the Moon		
craters	n.	陨石坑（复数形式）
gravity	n.	重力
footprints	n.	足迹（复数形式）
Moon	n.	月亮
protect	v.	保护
suit	n.	服装
jump	v.	跳跃
live	v.	生活
look	v.	看
Snowstorm		
is	v.	是
it	pron.	它
they	pron.	他们
flakes	n.	雪片（复数形式）
tougues	n.	舌头（复数形式）
deep	adj.	深的
Pinatas Are Fun		
are	v.	是
some	adj.	一些的
they	pron.	他们
pinatas	n.	皮纳塔（复数形式）
spun	v.	纺纱
treats	n.	甜食（复数形式）
swinging	v.	朝...挥去
Stella Storyteller		
take	v.	拿走
there	pron.	那里
went	v.	去（过去式）
cookies	n.	饼干（复数形式）
dessert	n.	甜点
explained	v.	解释（过去式）
playdate	n.	玩耍约会
Rock Climbing		
boulders	n.	石头（复数形式）
brave	adj.	勇敢的
carefully	adv.	认真地
climbing	v.	爬
helmet	n.	头盔
protect	v.	保护
and	conj.	并且
you	pron.	你
can	modal.	能够
Stop It, Zots!		
board	n.	木板
bored	adj.	无聊的
bounces	v.	跳（第三人称单数）
pretend	v.	假装
quietly	adv.	安静地
rocks out	v.	演奏摇滚乐
do	v.	做
in	prep.	在...里面
say	v.	说
