The Chase		
into	prep.	进入
up	prep.	向上
ditch	n.	沟渠
escaped	v.	逃跑（escape的过去式）
field	n.	田野
leapt	v.	跳跃（leap的过去式）
meadow	n.	牧场
shore	n.	岸边
chased	v.	追赶
crud	n.	脏东西
fellow	n.	家伙
flash	n.	闪光，一瞬间
spat	n.	口角
The Food We Eat		
from	prep.	来自
bagels	n.	百吉饼，面包圈
cattle	n.	牛（总称）
hamburger	n.	汉堡
omelets	n.	煎蛋卷
pepperoni	n.	意大利辣香肠
wheat	n.	小麦
animals	n.	动物们
cheese	n.	奶酪
food	n.	食物
plants	n.	植物
sauce	n.	酱汁
Groundhog Goes Outside		
burrow	n.	洞穴
cheer	v.	欢呼
gathered	v.	集中，聚集
grinned	v.	咧嘴笑
shadow	n.	影子
worried	adj.	担忧的
Grow Tomatoes in Six Steps		
they	pron.	它们
when	adv.	什么时候
when	conj	当...时
bloom	v.	开花
seedling	n.	秧苗
soil	n.	土壤
stake	n.	桩，棍子
tomatoes	n.	西红柿
transplant	v.	移植
Laws for Kids		
must	aux.	必须
we	pron.	我们
accident	n.	事故
follow	v.	遵守
laws	n.	法律
own	v.	拥有
protect	v.	保护
traffic	n.	交通
