The International T-Shirt Challenge		
currency	n.	货币
Internet	n.	互联网
search engine	n.	搜索引擎
strategy	n.	策略
stumpers	n.	难题
phenomenal	adj.	了不起的
weblogs	n.	博客
euros	n.	欧元
pesetas	n.	比塞塔（西班牙以前的货币）
pounds	n.	英镑
rupees	n.	卢比（印度等国的货币单位）
Life in Space		
astronauts	n.	宇航员
gravity	n.	重力
launched	v.	发射（动词过去式）
orbited	v.	沿轨道运行（动词过去式）
space station	n.	空间站
training	n.	训练
cosmonaut	n.	航天员
mission	n.	使命
nozzle	n.	管口
untangle	v.	解开
vehicle	n.	交通工具
abandon	v.	抛弃
Martin Luther King, Jr.		
boycott	v.	抵制
civil right	n.	民权
leadership	n.	领导才能
march	n.	示威游行
resisted	v.	抵制（动词过去式）
segregated	adj.	隔离的
facilities	n.	场所
mourned	v.	哀悼（动词过去式）
register	v.	登记
equality	n.	平等
desegregation	n.	消除种族隔离
organizaiton	n.	组织
Aesop's Fables		
compliments	n.	赞扬
flattering	adj.	奉承的
greedy	adj.	贪婪的
humble	adj.	谦逊的
persistence	adj.	坚持不懈
strengths	n.	体力
devised	v.	想出（动词过去式）
raspy	adj.	沙哑刺耳的
slurped	v.	发出啧啧的声音（动词过去式）
Harriet Tubman and the Underground Railroad		
abolitionists	n.	主张废除…的人
escapee	n.	逃亡者
meager	adj.	贫瘠的
perilous	adj.	艰难的
plantation	n.	种植园
Underground Railroad	n.	地下逃亡线
compartment	n.	隔间
enslaved	adj.	使成为奴隶
illegal	adj.	不合法的
injustice	n.	不公正
network	n.	关系网
scouting	v.	侦查
India		
endangered	adj.	濒危的
Hindu	adj.	印度教的
mangrove	n.	红树林
monsoon	n.	季风
Muslims	n.	伊斯兰教信徒
peninsula	n.	半岛
sacred	adj.	神的
subcontinent	n.	次大陆
Arabian	adj.	阿拉伯的
rural	adj.	乡村的
pronounce	v.	发音
Animals Feel Emotions		
compassion	n.	同情
devotion	n.	关爱
evidence	n.	证据
instincts	n.	本能
loyalty	n.	忠诚
passive	adj.	消极的
abandon	v.	放弃
amputate	v.	切断
ecstatically	adv.	欣喜若狂地
eventually	adv.	最后
malignant	adj.	恶性的
rambunctious	adj.	喧闹而活跃的
Ghosts in the House		
annoyed	adj.	恼怒
devised	v.	想出
escapees	n.	逃亡者
haunted	adj.	闹鬼的
lullaby	n.	摇篮曲
Underground Railroad	n.	地下逃亡线
cornhusks	n.	玉米外壳
feverishly	adv.	狂热地
scolded	v.	训斥
confused	v.	疑惑
amused	adj.	惊奇的
attic	n.	阁楼
Barack Obama		
civil right movement	n.	公民人权运动
degree	n.	学位
ethnicity	n.	种族特点
heritage	n.	遗产
injustices	n.	不公正
races	n.	种族
continents	n.	大陆
honors	n.	荣誉
inspired	v.	激励
local	adj.	当地的
moved	v.	使...感动
passion	n.	热情
reputation	n.	名誉
segregation	n.	隔离政策
ashamed	adj.	惭愧的
Bites and Stings		
assessing	v.	评估
diagnosis	n.	诊断
inflammation	n.	发炎
puncture	n.	刺伤
symptoms	n.	症状
venom	n.	毒液
antivenom	n.	抗蛇毒血清
blood pressure	n.	血压
clotting	v.	(血或乳脂)凝结成块
culprit	n.	肇事者
discoloration	n.	变色
disorders	n.	混乱
docile	adj.	温顺的
embedded	v.	嵌入
harassing	v.	侵扰
local	adj.	当地的
site	n.	地点
syndrome	n.	综合症状
Butterflies and Moths		
cocoon	n.	茧
exoskeleton	n.	外骨骼
insects	n.	昆虫
invertebrates	n.	无脊椎动物
molting	v.	蜕皮
species	n.	物种
antennae	n.	触角
caterpillar	n.	毛毛虫
chrysalis	n.	蛹
larval	adj.	幼虫的
life cycle	n.	生命周期
metamorphosis	n.	变形
migrate	v.	迁徙
predator	n.	捕食者
pupal	adj.	蛹的
Groundwater		
conserve	v.	保护
crisis	n.	危机
drought	n.	干旱
groundwater	n.	地下水
irrigate	v.	灌溉
resource	n.	资源
aquifers	n.	含水层
climate change	n.	气候变化
monitor	v.	监测
winemaker	n.	葡萄酒生产者
property	n.	庄园
conflict	n.	矛盾
Morty the Meany		
apologetic	adj.	道歉的
dejected	adj.	沮丧的
humiliation	n.	羞辱
indignation	n.	愤慨
mortified	adj.	感到屈辱的
overcome	adj.	不知所措的
annoyance	n.	恼怒
sheepishly	adj.	不好意思地
sulked	v.	生闷气（动词过去式）
insist	v.	坚决要求
irritated	v.	使烦恼（动词过去式）
dreadful	adj.	糟糕透顶的
Our Solar System		
atmosphere	n.	大气层
diameter	n.	直径
meteor	n.	流星
meteorite	n.	陨石
orbit	n.	轨道
orbits	v.	围绕…运动
fossil fuel	n.	化石燃料
gravitational pull	n.	引力
meteoroid	n.	流星体
Jupiter	n.	木星
Uranus	n.	天王星
Neptune	n.	海王星
Mercury	n.	水星
Penguins		
algae	n.	藻类
conservation	n.	保护
insulation	n.	隔热
pollution	n.	污染
species	n.	物种
streamlined	adj.	流线型的
waddle	n.	摇摆的步子
hemisphere	n.	半球
awkward	adj.	笨拙的
tobogganing	n.	滑行
The Titanic Lost and Found		
contraptions	n.	奇特的装置
dire	adj.	极其严重的
frantically	adj.	疯狂地
magnificent	adj.	壮丽的
ominously	adv.	不祥的
steerage	n.	统舱
lavish	adj.	耗资巨大的
tragedy	n.	灾难
rescued	v.	救援（动词过去式）

