Believe It or Not		
evidence	n.	证据
extraterrestrials	n.	外星人
hoax	n.	骗局
mysteries	n.	谜团
pharaoh	n.	法老
retracted	v.	撤回
encounters	n.	遭遇
hover	v.	悬停
intricate	adj.	错综复杂的
microwave	n.	微波
node	n.	节点
plasma	n.	等离子体
The Great Hunger		
blight	n.	疫病
decay	n.	衰败
emigrants	n.	移民
famine	n.	饥荒
starvation	n.	饥饿
tenant	n.	佃户
homeland	n.	祖国
immigrants	n.	移民
lreland	n.	爱尔兰
landlords	n.	地主
population	n.	人口
workhouse	n.	济贫院
Neil deGrasse Tyson Star Man		
astronomy	n.	天文学
astrophysicist	n.	天体物理学家
classified	v.	分类
debate	n.	辩论
physics	n.	物理
planetarium	n.	天文馆
commissions	n.	委员会
debris	n.	碎片
demoted	v.	降级
doctorate	n.	博士学位
infamous	adj.	臭名昭著的
supernovas	n.	超新星
Battling for Independence		
independence	n.	独立
Loyalists	n.	效忠派
Patriots	n.	爱国者
representation	n.	代表
retaliated	v.	反击、报复
self-governing	adj.	自治
allies	n.	盟友
amends	n.	修正
colonies	n.	殖民地
delegates	n.	代表
gunpowder	n.	火药
momentum	n.	势头
morale	n.	士气
petition	n.	请愿
rebellion	n.	叛乱
Prehistoric Giants (Other Than Dinosaurs)		
eras	n.	时代
extinct	adj.	灭绝的
habitats	n.	栖息地
paleontologists	n.	古生物学家
prehistoric	adj.	史前的
species	n.	物种
amphibians	n.	两栖动物
arthropod	n.	节肢动物
herbivores	n.	食草动物
ice age	n.	冰河时代
invertebrates	n.	无脊椎动物
tentacles	n.	触手
The Bones of a King		
archaeologist	n.	考古学家
deformity	n.	畸形
DNA	n.	DNA
medieval	adj.	中世纪的
monastery	n.	修道院
propaganda	n.	宣传
ascended	v.	登上
betrayed	v.	背叛
carbon dating	n.	碳测年
descendants	n.	后代
despised	v.	鄙视
monarchs	n.	君主
What Do You Think About Climate Change		
climate	n.	气候
fossil fuels 	n.	化石燃料
global warming	n.	全球变暖
greenhouse gases	n.	温室气体
pollutants	n.	污染物
renewable energy	n.	可再生能源
atmosphere 	n.	大气
axis	n.	轴
computer models	n.	计算机模型
geothermal	adj.	地热
galaciers 	n.	冰川
greenhouse effect	n.	温室效应
hydropower 	n.	水力发电
ice ages	n.	冰河时代
ice shelf	n.	冰架
industrialization	n.	工业化
meteorologists	n.	气象学家
orbit	n.	轨道
photosynthesis	n.	光合作用
The Case of the Disappearing Honeybees		
colonies	n.	群落
compromised	adj.	受损的
disorder	n.	紊乱
pollinate	v.	授粉
sanctuaries	n.	保护区
surveyed	v.	调查
dissected	v.	解剖
fertilization	n.	受精
forage	v.	觅食
parasites	n.	寄生虫
pesticides	n.	杀虫剂，农药
systemic	adj.	系统性的
Marie Curie		
breakthroughs	n.	突破
element	n.	元素
Nobel Prize	n.	诺贝尔奖
perseverance	n.	毅力
physics	n.	物理学
Sorbonne	n.	索邦大学
anemia	n.	贫血
commission	n.	委托
doctorate	n.	博士学位
electrometer	n.	静电计
nominated	v.	提名
X-rays	n.	X射线
Sacagawea and the Corps of Discovery		
Corps of Discovery	n.	发现军团
inhabited	adj.	居住
interpreters	n.	口译员
kidnapped	v.	绑架
waterway	n.	水道
expedition	n.	远征；探险
fortitude	n.	坚韧不拔
Louisiand Territory	n.	路易斯安那领地
navigational	adj.	导航的
negotiations	n.	谈判
Northwest Passage	n.	西北航道
Goliath Beetles Giant Insects		
species	n.	物种
solitary 	adj.	独自的
circulatory systems	n.	循环系统
naturalists	n.	博物学家
scarab	n.	圣甲虫
entomologists	n.	昆虫学家
modified	n.	改良的
metamorphosis	n.	变态
larval	n.	幼虫
pupal	n.	蛹
captivity	n.	圈养
elusive	adj.	难以捉摸的
Spoiled Sports The Dangers of Steroids		
cheater	n.	作弊者
hormone	n.	激素
scandals	n.	丑闻
side effects	n.	副作用
steroids	n.	类固醇
synthetic	n.	合成
competitive	adj.	竞赛的
illegally	adv.	非法地
puberty	n.	青春期
reputation	n.	声誉
stamina	n.	耐力
stunted	adj.	发育不良的
