How to Make a Drum		
balloon 	n.	气球
cardboard	n.	硬纸板
drum	n.	鼓
drumsticks	n.	鼓槌
scissors	n.	剪刀
tube	n.	管状物
have	v.	有
make	v.	制作
with	prep.	用…
construction paper	n.	建筑用纸（彩色美术纸）
rubber bands 	n.	橡皮筋
stretch	v.	拉伸
Math Test Mix-Up		
know	v.	知道
said	v.	说（say的过去式）
which	pron.	哪个
directions 	n.	指令，指示
finished	v.	完成
mistake	n.	错误
questions	n.	问题
studied	v.	学习
writing	n.	笔迹
decide 	v.	决定
easy	adj.	简单的
hard	adj.	困难的
test	n.	测试
Nature Stinks!		
enemies 	n.	敌人
liquid	n.	液体
mates	n.	配偶
rotten	adj.	腐烂的
sprays	v.	喷射
stinky	adj.	臭臭的
it	pron.	它
some 	pron.	一些
this	pron.	这个
Moose on the Move		
antlers	n.	鹿角
clearing	n.	空地
dam	n.	坝，堤
hooves	n.	蹄子
understand	v.	理解
upset	adj.	心烦意乱的
Soccer		
countries	n.	国家
net	n.	球网
fans	n.	球迷
sport	n.	运动
goal	n.	球门
teams	n.	球队
		