All About Kites 		
bridle 	n.	缰绳
currents	n.	气流
instruments	n.	仪器，设备
inventor	n.	发明家
parafoil	n.	翼伞
shock	n.	震惊
diplomat	n.	外交官
flutter	v.	振翼, 拍翅膀
fishhook	n.	鱼钩
imitating	v.	模仿
legend	n.	传说
designed 	v.	设计
terrified 	adj.	害怕的
Bedbugs Bite! 		
developing 	adj.	正在发育的
digests	v.	消化
infected	adj.	被感染的
mattress	n.	 床垫；褥子
suitcase	n.	行李箱
victims	n.	受害者
critters	n.	小动物
mosquitoes 	n.	蚊子
molts 	v.	蜕皮
germs 	n.	细菌
disease 	n.	疾病
attracted	v.	吸引
Luna Has Nothing to Wear 		
dazzling 	adj.	炫目的
dimmed	v.	变昏暗
elastic 	adj.	松紧带的
figure 	n.	体形
fitting 	v.	适合（fit的现在分词）
galaxy 	n.	银河系
orbited 	v.	围绕…移动
swelling 	v.	膨胀的
tuxedo 	n.	燕尾服
glow	v.	发光
attention	n.	关注
tripped	v.	绊倒
ashamed	adj.	羞愧的
The Butterfly Life Cycle 		
larva	n.	幼虫
life cycle	n.	生命周期
mate	n.	配偶
molting	n.	蜕皮
pupa	n.	蛹
stages	n.	阶段
emerge 	v.	出现
pattern	n.	样式，形式
prepare	v.	准备
process	n.	过程
similar	adj.	相似的
transform	v.	变形
constantly 	adv.	不断地
splits	v.	劈开
completely 	adv.	完全地
delicate 	adj.	纤弱的
Coral Reefs 		
algae	n.	藻类
coral reefs	n.	珊瑚礁
diseases	n.	病害
fragile	adj.	脆弱的
polyps	n.	珊瑚虫
skeletons	n.	骨架
explosives 	n.	爆炸物
smother	v.	使窒息
surface	n.	表面
Día de los Muertos 		
altars	n.	祭坛
cemetery	n.	墓地
cultures	n.	文化
spirits	n.	灵魂
traditions	n.	传统,惯例
honors 	v.	致敬，尊敬
celebrate 	v.	庆祝
decorate	v.	装饰
remember	v.	纪念
shreds 	v.	撕碎
mixture 	n.	混合物
marigolds 	n.	万寿菊
frosting 	n.	糖霜
memories 	n.	回忆（momery的复数）
Persephone A Greek Myth 		
fate 	n.	命运
goddess	n.	女神
grieved	v.	悲伤
pomegranate	n.	石榴
tempted	v.	诱惑
underworld	n.	(神话中的)冥界
barren 	adj.	贫瘠的
chariot	n.	敞篷双轮马车
plunging	v.	冲进
willingly 	adv.	愿意地
immediately 	adv.	立即
Dr. King’s Memorial 		
civil rights 	n.	公民权利
laws	n.	法律
memorial 	n.	纪念碑
peaceful	adj.	和平的
racism	n.	种族主义，种族歧视
segregated	adj.	隔离的
inspire	v.	激励，鼓舞
enforced 	v.	强制执行
protested	v.	抗议
arrested 	v.	逮捕
separate	adj.	分开的，分离的
supporters 	n.	支持者
marched 	v.	示威游行
nonviolent	adj.	非暴力的
delivered 	v.	发表
