Butterfly Café 		
café 	n.	小餐厅
milkweed	n.	乳草植物
monarch	n.	帝王
nectar	n.	花蜜
shelter	n.	庇护所
sprouts	n.	发芽
customers	n.	顾客
plant	v.	种植
soil	n.	土壤
from	prep.	来自
our	pron.	我们的
some	pron.	一些
their	pron.	它们的
Condors Giant Birds		
bathing	v.	洗浴
cliffs	n.	悬崖
feathers	n.	羽毛
land	v.	着陆
nests	n.	鸟巢
wing	n.	翅膀
Carlos’s First Thanksgiving		
made 	v.	做（make的过去式）
their	pron.	他们的
there	adv.	那里
turkey	n.	火鸡
dessert	n.	餐后甜点
holiday	n.	假期
neighbors	n.	邻居
tamales	n.	玉米粉蒸肉
Thanksgiving	n.	感恩节
pasta	n.	面食
share	v.	分享
Elephants Giant Mammals		
breathe	v.	呼吸
calf	n.	小象
female	adj.	雌性
males	n.	雄性
trunks	n.	象鼻
weigh	v.	重
Cinderella		
fit 	v.	适合
grave	n.	坟墓
married	v.	结婚
midnight	n.	午夜
twig	n.	细枝
wish	v.	希望
gave	v.	给（give的过去式）
said	v.	说（say的过去式）
work	n.	工作
