Oh, Raccoon		
awake	adj.	醒来的
hungry	adj.	饥饿的
messy	adj.	脏乱的
racoon	n.	浣熊
smart	adj.	聪明的
sneaky	adj.	狡猾的
is	v.	是
Opposites		
is	v.	是
this	pron.	这个
closed	adj.	关闭的
down	adv.	向下
fast	adj.	快的
slow	adj.	慢的
open	adj.	打开的
Our Apartment Building		
apartment	n.	公寓
building	n.	建筑物
city	n.	城市
elevator	n.	电梯
hallway	n.	走廊
mailbox	n.	邮箱
is	v.	是
our	pron.	我们的
this	pron.	这个
The Parade		
I	pron.	我
see	v.	看见
the	art.	这个
balloons	n.	气球（复数）
clowns	n.	小丑（复数）
drums	n.	鼓（复数）
flags	n.	旗帜（复数）
parade	n.	游行
Pond Animals		
I	pron.	我
see	v.	看见
pond	n.	池塘
swans	n.	天鹅（复数）
turtles	n.	乌龟（复数）
worms	n.	虫子（复数）
Rabbits		
is	v.	是
this	pron.	这个
fluffy	adj.	毛茸茸的
short	adj.	短的
tall	adj.	高的
white	adj.	白色的
The Rainstorm		
I	pron.	我
see	v.	看见
the	art.	这个
clouds	n.	云彩（复数）
lightning	n.	闪电
puddle	n.	水坑
rainbow	n.	彩虹
sky	n.	天空
Safe, Not Safe		
fire	n.	火
ice	n.	冰
water	n.	水
safe	adj.	安全的
street	n.	街道
is	v.	是
not	adv.	不
this	pron.	这个
Scary, Not Scary		
house	n.	房子
mask	n.	面具
scary	adj.	可怕的
treat	n.	款待
trick	n.	把戏
is	v.	是
not	adv.	不
this	pron.	这个
Shapes in Nature		
I	pron.	我
see	v.	看见
circle	n.	圆形
oval	n.	椭圆形
shape	n.	形状
spiral	n.	螺旋
square	n.	正方形
triangle	n.	三角形
