Friends Around the World		
aquarium 	n.	水族馆
barbecued	adj.	烧烤的
favorite	adj.	最喜欢的
ping-pong	n.	乒乓球
porridge	n.	粥
silk	n.	丝绸
like	v.	喜欢
live	v.	居住
City Falcons		
chicks 	n.	雏鸟
falcons	n.	猎鹰
hungry	adj.	饥饿的
nest box	n.	巢箱
prey	n.	猎物
webcam	n.	网络摄像机
down	adv.	向下
enough 	adv.	足够地
return	v.	返回
The Grand Canyon		
canyon 	n.	峡谷
erosion	n.	侵蚀
national	n.	国家的
park	n.	公园
Native Americans	n.	美洲原住民
protected	v.	受保护的
sediment	n.	沉积物
Club Monster		
all	adj.	所有的
should	aux. 	应该
clubhouse 	n.	俱乐部场所
garden	n.	园艺
hiking	n.	远足
passwords	n.	密码，口令
practice	v.	练习
squash	v.	挤扁
slush	n.	沙冰
squeeze	v.	挤压
squish	v.	挤扁
Hawaii Volcanoes National Park		
active 	adj.	活跃的
lava	n.	(熔岩冷凝后的)火山岩
melted	adj.	融化的
national park	n.	国家公园
protected	adj.	受保护的
tunnels	n.	隧道；地下道
another 	adj.	另一个的
became	v.	成为（become的过去式）
through	prep.	通过，穿过
volcano	n.	火山
