Giant Pumpkins		
compete	v.	竞赛
hobby	n.	爱好
nutrients	n.	营养物（复数）
pumpkins	n.	南瓜（复数）
record	n.	记录
weighed	v.	称重（过去式）
compost	n.	堆肥
pollinated	v.	授粉（过去式）
gigantic	adj.	巨大的
prizewinning	adj.	得奖的
prune	v.	修剪
Park Rangers		
experts	n.	专家（复数）
national	adj.	国家的
park ranger	n.	护林员
preserve	v.	保护
public	adj.	公众的
visitors	n.	游客（复数）
glaciers	n.	冰川（复数）
memorial	n.	纪念碑
museums	n.	博物馆（复数）
flashlight	n.	手电筒
sunscreen	n.	防晒霜
