Terell's Taste Buds		
breakfast 	n.	早餐
dinner 	n.	晚餐
fussy 	adj.	挑剔的
habits 	n.	习惯
lunch 	n.	午餐
taste buds 	n.	味蕾
Spring Is Here		
buds 	n.	芽
bulbs 	n.	灯泡
dandelion 	n.	蒲公英
gophers 	n.	地鼠
shoots 	n.	芽
water lily 	n.	荷花
garden	n.	花园
meadow	n.	草地
pond	n.	池塘
wiggly 	adj.	蠕动
woods	n.	树木
Monsters on Wheels		
helmets	n.	头盔
love	v.	爱
skateborad	n.	滑板
snowboard	n.	滑雪板
snowflake	n.	雪花
unicycle	n.	独轮车
Friends Around the World		
aquarium 	n.	水族馆
barbecued	adj.	烧烤的
favorite	adj.	最喜欢的
ping-pong	n.	乒乓球
porridge	n.	粥
silk	n.	丝绸
like	v.	喜欢
live	v.	居住
Pip, the Monster Princess		
daring	adj.	大胆的
dream	v.	做梦
fancy	adj.	花哨的
glitter	n.	闪光
princess	n.	公主
strolls	v.	散步
My First Library Card		
borrow 	v	借
checked out 	v.	检查过了
due 	adj.	到期的
favorite 	adj.	最喜欢的
library 	n.	图书馆
scans 	v	扫描
return	v	返回
sequence	v	顺序
though	conj.	尽管
Butterfly Café		
café 	n.	小餐厅
milkweed	n.	乳草植物
monarch	n.	帝王
nectar	n.	花蜜
shelter	n.	庇护所
sprouts	n.	发芽
customers	n.	顾客
plant	v.	种植
soil	n.	土壤
from	prep.	来自
our	pron.	我们的
some	pron.	一些
their	pron.	它们的
Blackbeard the Pirate		
pirate 	n.	海盗
real	adj.	真实的
rob	v.	抢夺
sailed	v.	航行
skeleton	n.	骷髅
treasure	n.	宝藏
was	v.	是（is的过去式）
very	adv.	非常
My Eid al-Fitr		
agreed 	v	同意
Eid al-Fitr 	n.	开斋节
excited 	adj	兴奋的
Muslims 	n.	穆斯林
new moon 	n.	新月
Ramadan 	n.	斋月
another	adj	其他
detail	n.	细节
idea	n.	主意
I'd Like To Be		
auto	n.	汽车
discover	v.	发现
fantasy	n.	奇幻故事
greasy	adj.	多油的; 油污的
stew	n.	炖菜
vet	n.	兽医
help	v.	帮助
question	n.	问题
gaze	v.	凝视, 注视
Saturn	n.	土星
Blizzard Blackout		
normal 	adj.	正常的
power	n.	能量
pretend	v.	假装
spooky	adj.	吓人的
squeezed	v.	挤
storm	n.	暴风雨
finally 	adv.	最后
Condors Giant Birds		
bathing	v.	洗浴
cliffs	n.	悬崖
feathers	n.	羽毛
land	v.	着陆
nests	n.	鸟巢
wing	n.	翅膀
The Empty Pot		
boiled 	adj.	沸腾的
China	n.	中国
emperor	n.	皇帝
empty	adj.	空的
honest	adj.	诚实的
well	n.	水井
his	pron.	他的
best	adj.	最好的
Dr. King’s Memorial		
fair 	adj.	公平的
laws	n.	法律
marched	v.	示威游行
memorial	n.	纪念碑
peaceful	adj.	和平的
separate	adj.	分开的
different	adj.	不同的
remember	v.	记得
same	adj.	相同的
Club Monster		
all	adj.	所有的
should	aux. 	应该
clubhouse 	n.	俱乐部场所
garden	n.	园艺
hiking	n.	远足
passwords	n.	密码，口令
practice	v.	练习
squash	v.	挤扁
slush	n.	沙冰
squeeze	v.	挤压
squish	v.	挤扁
Wing's Visit to Singapore		
caught 	v	抓住（catch的过去式）
fishing pole 	n.	钓鱼竿
hook 	n.	钩
jetty 	n.	码头
line 	n.	线
worm 	n.	虫子
catch	v.	抓住
Singapore	n.	新加坡
threw	v	扔了
Weird Bird Beaks		
breakfast 	n.	早餐
horn	n.	喇叭
long	adj.	长的
shaped	v	成形
use	v	使用
weird	adj.	诡异的
A Desert Counting Book		
cactus	n.	仙人掌
desert	n.	沙漠
javelina	n.	野猪
quail	n.	鹌鹑
rattlesnake	n.	响尾蛇
roadrunner	n.	走鹃
At a Touch Tank		
live	v.	居住
many	pron.	很多
when	conj.	当…的时候
Alaska	n.	阿拉斯加州
anemones	n.	海葵
gently	adj.	轻轻地；温柔地
sea cucumber	n.	海参
tentacles	n.	触须
touch tank	n.	触摸水箱
