The Genius of Tesla		
electricity	n.	电流
engineer	n.	工程师
experiment	n.	实验
inventions	n.	发明
investors	n.	投资者
patents	n.	专利
coil	n.	线圈
current	n.	电流
generator	n.	发电机
incandescent	adj.	发白热光的
visionary	n.	有远见的人
voltage	n.	电压
		
All About Chocolate		
cacao	n.	可可
conching	n.	混合搅拌
conquistador	n.	征服者
fermentation	n.	发酵
ingredients	n.	材料
mills	n.	磨粉机
consume	v.	消耗
mole	n.	墨西哥辣酱
machete	n.	大砍刀
		
The World's Biggest Library		
artifacts	n.	史前古器物
collection	n.	收藏品
communication	n.	交流
documents	n.	文档
exhibits	n.	展览
preserve	v.	保护
acquired	v.	取得
appointed	v.	任命
attraction	n.	有吸引力的事物
draft	n.	草稿
mosaics	n.	马赛克
research	n.	研究
		
More Valuable Than Gold		
conservation	n.	保护
contaminates	v.	污染
deforestation	n.	毁林
mining	v.	采矿
prospecting	n.	探矿
rainforest	n.	雨林
biodiversity	n.	生物多样性
illegal	adj.	非法的
mercury	n.	水银
ore	n.	矿石
sluices	n.	水闸
toxic	adj.	有毒的
		
Veterans Day		
armistice	n.	停战
casualties	n.	伤亡人员
civilian	n.	平民
combat	n.	战斗
recognition	n.	承认
sacrifices	n.	牺牲
allies	n.	同盟国
draft	n.	选拔队员制
post-traumatic stress disorder	n.	创伤后应激障碍
stationed	v.	驻扎
tuition	n.	学费
		
How Bees Make Honey		
capped	v.	给……加盖
digesting	v.	消化
evaporates	v.	蒸发
fertilization	n.	受精
pollen	n.	花粉
foragers	n.	搜寻（食物）的人
abdomens	n.	腹部
cooperation	n.	合作
critical	adj.	重要的
glands	n.	腺体
nurture	v.	养育
substance	n.	物质
		
Chichén Itzá		
ancient	adj.	古老的
architectural	adj.	建筑的
astronomy	n.	天文学
civilization	n.	文明
descendants	n.	后代
empire	n.	帝国
Maya	n.	玛雅人
offerings	n.	供品
peninsula	n.	半岛
restored	v.	修复
stepped pyramid	n.	阶梯金字塔
temples	n.	寺庙
		
The Super School Bus System		
integration	n.	结合
mass transit	n.	大众交通
rural	adj.	乡村的
school district	n.	学区
sparsely	adv.	稀疏地
transportation	n.	交通
discriminated	v.	区分
entitled	adj.	有资格的
fleet	n.	车队
principle	n.	原则
segregated	adj.	隔离的
Supreme Court	n.	最高法院
		
How to Build a Greenhouse		
climate	n.	气候
conditions	n.	环境
germinate	v.	发芽
greenhouse	n.	温室
humidity	n.	湿度
wavelengths	n.	波长
botany	n.	植物学
carbon dioxide	n.	二氧化碳
classify	v.	分类
foreign	adj.	国外的
hobbies	n.	爱好
photosynthesis	n.	光合作用
		
The Stanley Cup Hockey's Greatest Prize		
check	v.	检查
goalie	n.	守门员
playoff	n.	复赛
puck	n.	冰球
slap shot	n.	冰球挥杆射门
sudden death	n.	加时赛
benched	v.	把队员换下来
conference	n.	体育协会
dynasty	n.	朝代
quarterfinals	n.	四分之一决赛
semifinals	n.	半决赛
		
Electric Eels!		
electric	adj.	电的
electric current	n.	电流
shocks	n.	冲击
stun	v.	使震惊
top predators	n.	顶级捕食者
volts	n.	伏特
amplify	v.	放大
immune	adj.	免疫的
internal	adj.	内部的
navigate	v.	导航
organs	n.	器官
tributaries	n.	支流
		
Tundra		
adaptations	n.	适应
alpine	adj.	高山的
hibernate	v.	冬眠
migrate	v.	迁徙
permafrost	n.	多年冻土
remoteness	n.	遥远
fragile	adj.	脆弱的
global warming	n.	全球变暖
lichens	n.	地衣
nomadic	adj.	游牧的
photosynthesis	n.	光合作用
precipitaion	n.	降雨
