Animal Costumes		
bandanna	n.	印花手帕
costumes	n.	戏服
fins	n.	鱼鳍
mane	n.	鬣毛
snout	n.	猪鼻子
wear	v.	穿着，戴着
can	modal.	能够
of	prep.	的
too	adv.	也
A Day for Dad		
and	conj.	并且
I	pron.	我
on	prep.	在...上面
breakfast	n.	早餐
picnic	n.	野餐
plan	v.	计划
together	adv.	在一起
All About Foxes		
bushy	adj.	毛茸茸的
foxes	n.	狐狸
hunter	n.	捕猎者
fur	n.	皮毛
mammals	n.	哺乳动物
pointy	adj.	尖的
are	v.	是
have	v.	有
the	art.	这个
Future Flowers		
bulbs	n.	鳞茎植物
fall	n.	秋天
plan	v.	计划
plant	v.	种植
spring	n.	春天
winter	n.	冬天
but	conj.	但是
come	v.	来
is	v.	是
Animal Tongues		
has	v.	有
like	prep.	像
this	pron.	这个
brush	n.	刷子
sticky	adj.	粘性的
tongues	n.	舌头
thin	adj.	细的
Getting Around the City		
go	v.	去
goes	v.	去
my	pron.	我的
on	prep.	在...上面
to	prep.	去
ferry	n.	渡轮
taxi	n.	出租车
skateboard	n.	轮滑鞋
subway	n.	地铁
airport	n.	飞机场
Amazing Places to Work		
amazing	adj.	神奇的
captain	n.	船长
miner	n.	矿工
pilot	n.	飞行员
ranger	n.	护林员
stage	n.	舞台
work	v.	工作
on	art.	在...上面
this	pron.	这个
Give Them Back!		
an	art.	一个
from	prep.	来自
Easter	n.	复活节
hunt	v.	捕猎
sneaky	adj.	鬼鬼祟祟的
Animal Horns		
antelope	n.	羚羊
curved	v.	使弯曲
fighting	v.	打架
horns	n.	洞
scratching	v.	抓挠
straight	adj.	直的
has	v.	有
this	pron.	这个
use	v.	使用
I Did Not Give Up!		
float	v.	漂浮
give up	v.	放弃
important	adj.	重要的
keep	v.	坚持
tie	v.	系上
trying	v.	尝试
all	pron.	所有的
can	modal.	能够
now	adv.	现在
