Homemade Halloween		
costume	n.	服装
Halloween	n.	万圣节
homemade	adj.	家庭自制的
pinned	v.	用针别主
planned	v.	计划
stitched	v.	缝
Cockroaches		
amazing	adj.	神奇的
breathe	v.	呼吸
cockroaches	n.	蟑螂
insect	n.	昆虫
need	v.	需要
pest	n.	害虫
I Bet I Can		
jump	v.	跳
over	prep. 	越过
said	v.	说（say的过去式）
grabbed	v.	抓住（grab的过去式）
hawk	n.	鹰
kangaroo	n.	袋鼠
snap	v.	突然折断
splash	v.	使(液体)溅起
splat	v.	(使)啪哒作响
Going to the Doctor		
blood pressure 	n.	血压
checkup	n.	体检
cuff	n.	袖带
doctor	n.	医生
height	n.	身高
weight	n.	体重
around	prep. 	在...周围
like	v.	喜欢
my	pron. 	我的
The Legend of Nian		
China	n.	中国
Chinese New Year 	n.	中国新年（春节）
dragon	n.	龙
firecrackers	n.	鞭炮
noise	n.	噪声
scare	v.	使害怕
