All About Spiders		
climb	v.	爬
eggs	n.	卵（名词复数）
eight	adj.	八个的
lays	v.	产卵
silk	n.	丝
spiders	n.	蜘蛛（名词复数）
can	modal.	能够
has	v.	有
it	pron.	它
make	v.	制作
outside	adv.	外面
Get In		
duck	n.	鸭子
elephant	n.	大象
in	prep.	在...里面
man	n.	男人
pig	n.	猪
woman	n.	女人
boy	n.	男孩
cannot	v.	不能
girl	n.	女孩
can	modal.	能够
get	v.	到...
he	pron.	他
it	pron.	它
she	pron.	她
Go Away, Lily		
ate	v.	吃（过去式）
played	v.	玩（过去式）
ran	v.	跑（过去式）
read	v.	读（过去式）
sat	v.	坐着（过去式）
slept	v.	睡觉（过去式）
away	adv.	离开
go	v.	去
when	adv.	当...时
How Many		
candle	n.	蜡烛
kites	n.	风筝（名词复数）
smiles	n.	微笑（名词复数）
wheels	n.	车轮（名词复数）
wings	n.	翅膀（名词复数）
windows	n.	窗户（名词复数）
Machines  at Home		
blender	n.	搅拌器
dry	v.	使...干燥
freeze	v.	使...冷冻
machine	n.	机器
make	v.	使得
wash	v.	洗
we	pron.	我们
with	prep.	和
My Clothes Are Too Small		
brother	n.	兄弟
grown	v.	成长
small	adj.	小的
summer	n.	夏天
sweatshirt	n.	运动衫
too	adv.	太
my	pron.	我的
old	adj.	旧的
must	modal.	肯定
