Look At This Book! 		
autobiography 	n.	自传
biography	n.	传记
fantasy	n.	奇幻小说
informational	adj.	信息类的
mystery	n.	推理小说
science fiction	n.	科幻小说
when	conj.	当…的时候
read	v.	阅读
history	n.	历史
without	prep. 	没有
Moving Bridges		
accordion 	n.	手风琴
castles	n.	城堡
curl	v.	卷曲
drawbridges	n.	吊桥
safely	adv.	安全地
tilt	v.	倾斜
have	v.	有
many	pron.	很多
some	pron.	一些
different	adj.	不同的
underneath	prep. 	在…下面
Loose Tooth		
my	pron.	我的
on	prep.	在… 上
when	conj.	当…时
expect 	v.	预料
lose	v.	失去
tooth	n.	牙齿
tooth fairy	n.	牙仙
wiggly	adj.	晃动的
wonder	v.	想要知道
Taking the Train		
blows 	v.	吹
races	v.	全速行进
rocks	v.	来回摆动
rolls	v.	行驶
track	n.	轨道
train	n.	火车
get off	v.	下车
get on	v.	上车
through	prep. 	穿过
Miles the Nile Crocodile		
basks 	v.	晒太阳
crocodile	n.	鳄鱼
papyrus	n.	纸莎草
pyramids	n.	金字塔
sighs	v.	叹气
vegetarian	n.	素食主义者
ask	v.	问
down	prep.	沿着
no	adj.	没有
