Discovering Dinosaurs		
decayed	v.	腐烂（过去式）
dinosaurs	n.	恐龙（复数）
extinct	adj.	灭绝的
fossils	n.	化石
museum	n.	博物馆
paleontologists	n.	古生物学家
carnivores	n.	食肉动物
herbivores	n.	食草动物
scavengers	n.	食腐肉的兽(或鸟)
A Bad Movie		
gloated	v.	扬扬得意（过去式）
hesitated	v.	犹豫（过去式）
slumped	v.	重重地坐下（过去式）
sly	adj.	狡猾的
smirk	n.	傻笑
urged	v.	催促（过去式）
aisle	n.	过道
complex	n.	忧虑
manager	n.	经理
