Ants, Ants, and More Ants		
antennae	n.	触须
ground	n.	地面
insects	n.	昆虫
jaws	n.	下颚
nests	n.	巢穴
queen	n.	女王，王后
size	n.	大小
yard	n.	院子
guard	v.	保护
take care of	v.	照顾
The Camel and the Pig		
his	pron. 	他的
said	v.	说（say的过去式）
bet	v.	打赌
camel	n.	骆驼
hump	n.	驼峰
pig	n.	猪
short	adj.	矮的
tall	adj.	高的
Caring for Your Dog		
your	pron. 	你的
brushed	v.	刷（brush的过去分词）
care	n.	照顾
family	n.	家庭
fed	v.	喂养（feed的过去分词）
needs	n.	需要
treats	n.	奖励
spend	v.	度过
twice	adv.	两次
washed	v.	洗（wash的过去分词）
Calos Joins the Team		
come	v.	来，过来
play	v.	玩
your	pron. 	你的
baseball	n.	棒球
catch	v.	接住
join	v.	加入
miss	v.	错过
team	n.	队伍
watch	v.	观看
Fire Safety		
alarm	n.	警报
escape	v.	逃跑
fire department 	n.	消防队
panic	v.	恐慌的
practice	v.	练习
tips	n.	技巧
knob	n.	门把手
burn	v.	燃烧
