Cool as a Cuke 		
help	v.	帮助
cousin	n.	兄弟，姊妹
find	v.	找到
lost	adj.	迷路的
tricks	n.	杂技，杂耍
watermelon	n.	西瓜
whistle	v.	吹口哨
I Collect That!		
alike 	adj.	相像的
based	v.	以…为基础
coins	n.	硬币
collection	n.	收藏
meet	v.	(与…)会面
type	n.	类型
can	aux.	会，能
other	adj. 	别的, 其他的
collect	v.	收藏
The Day I Needed Help		
ankle	n.	脚踝
trails	n.	小径
ambulance 	n.	救护车
hospital	n.	医院
Search and Rescue	n.	搜索救援
sprain	n.	扭伤
stretcher	n.	担架
X-ray	n.	X光照片
broke	v.	摔断（break的过去式）
I’d Like to Be		
auto	n.	汽车
discover	v.	发现
fantasy	n.	奇幻故事
greasy	adj.	多油的; 油污的
stew	n.	炖菜
vet	n.	兽医
help	v.	帮助
question	n.	问题
gaze	v.	凝视, 注视
Saturn	n.	土星
A Desert Counting Book		
cactus	n.	仙人掌
desert	n.	沙漠
javelina	n.	野猪
quail	n.	鹌鹑
rattlesnake	n.	响尾蛇
roadrunner	n.	走鹃
		
