Nami’s Gifts		
clues 	n.	线索
collects	v.	收藏
gift	n.	礼物
tradition	n.	传统
last	n.	最后，末尾
next	adv.	接着，然后
then	adv.	然后
holidays	n.	假期
special	adj.	特别的
Statues in the Sand		
carve	v.	雕刻
amazing	adj.	神奇的
contests	n.	竞赛
sand castles	n.	沙堡
sculptors	n.	雕塑家
statues	n.	雕像
make	v.	制作
their	pron.	他们的
they	pron.	他们
Sister Daisy, Sister Rose		
apart 	adv.	区分
confused	adj.	混乱的
different	adj.	不同的
instrument	n.	乐器
style	n.	风格
twins	n.	双胞胎
they	pron.	他们
want	v.	想要
Statues in the Ice		
artists	n.	艺术家
carve	v.	雕刻
melt	v.	融化
shape 	v.	塑形
statue	n.	雕像
tools	n.	工具
make	v.	制做
they	pron.	他们
use	v.	使用
Smaller and Smaller		
see	v.	看到
saw	v.	看到（see的过去式）
too	adv.	也
very	adv.	非常
bigger	adj.	更大（big的比较级）
disappeared	v.	消失
farther	adv.	更远（far的比较级）
goodness	n.	上帝
reached	v.	到达
shrinking	v.	收缩，变小（shrink的现在分词）
