What in the World Is That 		
it	pron.	它
what	pron.	什么
bill 	n.	鸟喙
claw	n.	爪子
platypus	n.	鸭嘴兽
sleek	adj.	光滑的
strange	adj.	奇怪的
webbed	adj.	有脚蹼的
feathers 	n.	羽毛
gnaw	v.	啃，咬
whiskers	n.	胡须
Monsters’ Stormy Day		
day	n.	一天
says	v.	说
then	adv.	然后
circus 	n.	马戏团
flashlight	n.	手电筒
lightning	n.	闪电
monsters	n.	怪兽
stormy	adj.	暴风雨的
thunder	n.	雷
Places People Live		
some 	pron.	一些
they	pron.	他们
where	pron.	哪里
caves 	n.	洞穴
float	v.	漂浮
ground	n.	地面
live	v.	居住
move	v.	移动
place	n.	地方
above	prep.	在… 上面
below	prep.	在…下面
cliffs	n.	悬崖
glass	n.	玻璃
grass	n.	草
sticks	n.	木棍
stone	n.	石头
wheels	n.	轮子
My Day		
eat	v.	吃
my	pron.	我的
afternoon	n.	下午
bright	adj.	明亮的
evening	n.	傍晚
morning	n.	早晨
night	n.	夜晚
noon	n.	中午
Signs Are Everywhere		
tell	v.	告诉
they	pron. 	他们（主格）
us	pron. 	我们（宾格）
advertise	v.	给…打广告
posts	n.	标杆
signs	v.	标志
slowly	adv.	慢慢地
warnings	n.	警告
winding	adj.	蜿蜒的
