Code Talkers		
breaking	v.	破解
code	n.	密码
code talkers	n.	密码通讯员
discrimination	n.	区别
Navajo	n.	纳瓦霍人
serve	v.	提供
marines	n.	美国海军陆战队
symbols	n.	象征（复数)
transmit	v.	传输
A Golden Tragedy		
bewildered	adj.	困惑不解的
dithered	v.	犹豫不决(过去式）
embrace	n.	拥抱
enlist	v.	征集
frenzied	adj.	疯狂的
fretted	v.	苦恼（过去式）
furiously	adv.	有力地
glistened	v.	闪光
humble	adj.	谦逊的
pheasant	n.	野鸡; 雉
precious	adj.	珍奇的
tragic	adj.	悲惨的
wake	n.	航迹
wealthy	adj.	富有的
