Carlos Counts Kittens		
has	v.	有
kittens	n.	小猫
many	adj.	许多
Carlos Goes to School		
I	pron.	我
my	pron.	我的
backpack	n.	背包
crayons	n.	蜡笔
eraser	n.	橡皮
sweater	n.	毛衣
ruler	n.	尺子
Christmas Cookies		
bell	n.	铃铛
candle	n.	蜡烛
cookies	n.	饼干
flower	n.	花朵
snowflake	n.	雪花
Santa	n.	圣诞老人
snowman	n.	雪人
tree	n.	树
make	v.	制作
Clean, Not Clean		
clean	adj.	干净的
food	n.	食物
hand	n.	手
room	n.	房间
shoe	n.	鞋子
is	v.	是
not	adv.	不
this	pron.	这个
Dad and I		
bake	v.	烘焙
bike	v.	骑自行车
dad	n.	爸爸
garden	v.	种植花木
hug	v.	拥抱
play	v.	玩
swim	v.	游泳
walk	v.	走路
write	v.	写字
and	conj.	并且
I	pron.	我
Easy, Not Easy		
easy	adj.	容易的
game	n.	游戏
jump	n.	跳
math	n.	数学
not	adv.	不
puzzle	n.	拼图
is	v.	是
the	art.	这个
A Fish Sees		
book	n.	书
friend	n.	朋友
lamp	n.	台灯
picture	n.	图片
sees	v.	看见（第三人称单数）
toy	n.	玩具
a	art.	一个
For Mom		
carry	v.	搬运
clean	v.	打扫
cook	v.	烹饪
draw	v.	画画
mom	n.	妈妈
read	v.	读书
sleep	v.	睡觉
sing	v.	唱歌
smile	v.	微笑
for	prep.	为了
I	pron.	我
The Forest		
a	art.	一个
is	v.	是
this	pron.	这个
deer	n.	鹿
forest	n.	森林
fox	n.	狐狸
mushroom	n.	蘑菇
squirrel	n.	松鼠
stream	n.	溪流
Fruit Colors		
be	v.	是
can	modal.	可能
fruits	n.	水果
orange	adj.	橘子
yellow	adj.	黄色
