Jane Goodall		
Africa	n.	非洲
behave	v.	(行为或举止)表现
chimpanzees	n.	黑猩猩
scientist	n.	科学家
study	n.	研究
tools	n.	工具
Mike’s Good Bad Day 		
carving	v.	雕刻（carve的现在分词形式 ）
clumsy	adj.	笨拙的
festival	n.	节日
library	n.	图书馆
pumpkin	n.	南瓜
wrong	adv.	糟糕的
tripped	v.	绊倒
Dolphins		
female	adj.	雌性的
grab	v.	抓住，获取
mammals	n.	哺乳动物
pods	n.	海豚群
protect	v.	保护
steer	v.	控制方向
different 	adj.	不同的
instead	adv.	代替，反而
through	prep.	通过
Bonk and the Lucky Buckeye		
puts	v.	放
says	v.	说
acorn 	n.	橡木果
dresser	n.	橱柜
lucky	adj.	幸运的
monsters	n.	怪兽
mystery	n.	谜，神秘的事
pocket	n.	口袋
Dragonflies!		
adult	adj.	成年的
breathe	v.	呼吸
direction	n.	方向
hunt	v.	猎食
insects	n.	昆虫
pairs	n.	一双; 一对
A Broken Leg for Bonk		
accepted	v.	接受
apology	n.	道歉
bossy	adj.	爱指挥他人的
broken	adj.	摔断的
giant	adj.	巨大的
tumbles	v.	摔倒
Karate		
belt	n.	腰带
defend	v.	防守，保护
habits	n.	习惯
flow	v.	流动，使连贯
karate	n.	空手道
patient	adj.	耐心的
different	adj.	不同的
main	adj.	主要的
certain	adj.	确定的
The Three Little Pigs 		
little	adj.	小的
once	adv.	曾经，从前
their	pron.	他们的
brick 	n.	砖块
haystack	n.	干草堆
huff	v.	吹气
puff	v.	吸气
sticks	n.	木棍
straw	n.	稻草
boasted 	v.	自夸
growled	v.	咆哮着说
slurped	v.	出声地吃或喝 
Lincoln Loved to Learn		
always	adv.	总是
when	conj.	当…的时候
their	pron.	他们的
cabin	n.	小木屋
chores	n.	杂活
frontier	n.	偏僻的地方
ideas	n.	主意，想法
poor	adj.	贫穷的
presidents	n.	总统
How Glooskap Found Summer		
leader	n.	首领
giant	n.	巨人
invited	v.	邀请
woke	v.	叫醒（wake的过去式）
bloomed	v.	开花
melted	v.	融化
tears	n.	眼泪
rule	v.	掌管
drive	v.	驱赶		
The Everglades		
amazing	adj.	神奇的
areas	n.	地区
change	v.	变化
mild	adj.	温和的
national park	n.	国家公园
roots	n.	树根
different	adj.	不同的
became	v.	变得
problem	n.	问题
We Make Maple Syrup		
boil	v.	煮
drill	v.	钻孔
maple syrup	n.	枫糖浆
sap	n.	树液
spout	n.	(喷出的)水柱，液体柱
tap	v.	轻拍；轻击
real	adj.	真的
steam	n.	蒸汽
Owls Overhead		
attack	v.	攻击
darkness	n.	黑暗
hearing	n.	听力
hunt	v.	猎食
prey	n.	猎物
survive	v.	存活
can	aux.	能
their	pron.	他们的
use	v.	使用
Camping with Bonk		
asks	v.	问
his	pron.	他的
says	v.	说
afraid 	adj.	害怕的
camping	v.	野营
friend	n.	朋友
hikes	v.	远足
shivers	v.	发抖，颤抖
worries	v.	担心
blankie	n.	小毯子
thoughtful	adj.	体贴的，关心的
Families		
half sister	n.	同父异母或同母异父的妹妹
members	n.	成员
siblings	n.	兄弟姐妹
son-in-law	n.	继子
stepchildren	n.	继子女
stepfather	n.	继父
Cy and Medusa		
direct	adj.	直接的
mirrors	n.	镜片
monocle	n.	单片眼镜
shop class	n.	手工课
tested	v.	测试
visor	n.	护目镜
Ruby Bridges		
brave 	adj.	勇敢的
difference	n.	不同
fair	adj.	公平的
laws	n.	法律
separate	v.	分开，分离
South	n.	南方（美国南方各州）
Why Robins Hop		
beaks	n.	鸟喙
chase	v.	追赶
foxes	n.	狐狸
protect	v.	保护
robins	n.	知更鸟
tracks	n.	(动物留下的)足迹
chickens	n.	鸡
crow	n.	乌鸦
hummingbird	n.	蜂鸟
problem	n.	问题
sparrow	n.	麻雀
woodpecker	n.	啄木鸟
Slow and Slower		
avoid 	v.	避开，躲避
creep	v.	爬行；慢慢地移动；
energy	n.	能量
mammals	n.	哺乳动物
seldom	adv.	几乎不
sneaks	v.	潜行；溜走
Goldilocks and the Three Bears		
answered 	v.	回答
knocked	v.	敲门
medium	adj.	中等的, 适中的
porridge	n.	粥
returned	v.	返回
youngster	n.	孩子
climbed	v.	爬
owners	n.	所有者，主人
