Old and New		
bikes	n.	自行车（复数）
houses	n.	房子（复数）
new	adj.	新的
old	adj.	旧的
pickup trucks	n.	皮卡车（复数）
teddy bears	n.	泰迪熊（复数）
these	pron.	这些
Paint It Purple		
I	pron.	我
like	v.	喜欢
my	pron.	我的
not	adv.	不是
the	art.	这个
door	n.	门
fence	n.	栅栏
grass	n.	草地
hose	n.	水管
paint	v./n.	涂色；颜料
shoes	n.	鞋子
purple	n.	紫色
swing	n.	秋千
The Pet Rats		
chew	v.	咀嚼
class	n.	班级
climb	v.	爬
drink	v.	喝水
hide	v.	隐藏
sleep	v.	睡觉
run	v.	跑步
the	art.	这个
The Picnic		
in	prep.	在...里面
puts	v.	放（三单）
basket	n.	篮子
sandwiches	n.	三明治
chips	n.	薯片
soda pop	n.	苏打水
cookies	n.	饼干
Rain in the City		
I	pron.	我
see	v.	看见
the	art.	这个
drain	n.	下水道
lightning	n.	闪电
puddle	n.	水坑
rainbow	n.	彩虹
umbrella	n.	雨伞
Three Baby Birds		
one	pron.	其中一个
there	adv.	那里
three	num.	三个
two	num.	二个
were	v.	是
away	adv.	离开
grew	v.	成长
flew	v.	飞
rest	v.	休息
So Many Shops		
cheese	n.	奶酪
fruit	n.	水果
meat	n.	肉
sells	v.	售卖
shop	n.	商店
vegetables	n.	蔬菜
many	adj.	许多
so	adv.	如此
this	pron.	这个
Too Many Leaves		
I	pron.	我
the	art 	这个
gold	adj.	金色的
leaves	n.	树叶
rake	v.	耙
Taking Care of Chase		
I	pron.	我
my	pron.	我的
new	adj.	新的
dry	v.	使...变干
feed	v.	喂养
wash	v.	洗
pet	v.	抚摸
Too High		
chair	n.	椅子
hook	n.	挂钩
hoop	n.	篮框
roof	n.	房顶
shelf	n.	架子
sink	n.	水槽
is	v.	是
this	pron.	这个
too	adv.	太
