Animal Skeletons 		
bones 	n.	骨头
different	adj.	不同的
hollow	adj.	中空的，凹陷的
light	adj.	轻的
skeleton	n.	骨架
support	n.	支撑
looks	v.	看起来
many	adj.	很多的
this	pron.	这个
your	pron.	你的
Bonk, the Healthy Monster		
customer 	n.	顾客
dentist	n.	牙医
exercise	n.	锻炼
healthy	adj.	健康的
picnic	n.	野餐
piggy bank	n.	小猪存钱罐
All About Snakes 		
fangs 	n.	尖牙
hibernate	v.	冬眠
prey	n.	猎物
reptiles	n.	爬行动物
scales	n.	鳞片
venom	n.	毒液
live	v.	居住
some	pron.	一些
they	pron.	它们
beneath	prep.	在…下面
control	v. 	控制
use	v.	使用
Bonk at the Barbershop 		
bandage	n.	绷带
curly	adj.	卷的
mirror	n.	镜子
pedal	v.	踩踏板；骑
shaved	v.	剃发
shoulders	n.	肩膀
slippers 	n.	拖鞋
haircut 	n.	理发
instead 	adv.	代替
helmet	n.	头盔
Amazing Antarctica 		
continents	n.	大洲
dangerous	adj.	危险的
frozen	adj.	结冰的
globe	n.	地球
protect	v.	保护
scientists	n.	科学家
come	v.	来
work	v.	工作
however 	adv.	然而
important	adj.	重要的
study	v.	研究
Changes 		
changing	v.	变化（change的现在分词）
downtown	n.	商业区
life	n.	生活
moved	v.	搬家
remember	v.	记得
surprise	n.	惊喜
anywhere	adv.	到处
everything	pron.	所有东西
sometimes	adv.	有时
Being Bilingual 		
bilingual 	adj.	双语的，会两种语言的
Incas	n.	印加人
keyboards	n.	键盘
language	n.	语言
nation	n.	民族
weave	v.	编织
French 	adj.	法语
Mandarin 	n.	普通话
Spanish 	n.	西班牙语
The Creature Constitution 		
agreed 	v.	同意
argue	v.	争吵
constitution	n.	宪法
rules	n.	规则
signed	v.	签名
tired	adj.	累的
The Amazing Octopus 		
blend	v. 	混入，和…融为一体
hatch	v. 	孵化
predators 	n.	捕食者
prey	n.	猎物
squirt	v. 	喷出
venom	n.	毒液
incredible 	adj.	不可思议的
creatures 	n.	生物
ink 	n.	墨汁
attacker 	n.	攻击者
Bonk’s New Bike 		
bike 	n.	自行车
business	n.	生意
dreams	n.	梦想
handlebars	n.	车把
money	n.	钱
piggy bank 	n.	小猪存钱罐
earn 	v.	赚，赚得
Egypt 		
delta 	n.	三角洲
desert 	n.	沙漠
museums 	n.	博物馆
pharaohs 	n.	法老
pyramids 	n.	金字塔
tombs 	n.	古墓，陵墓
million 	n.	百万
capital 	n.	首都
Arabic	n.	阿拉伯语
Nile River 	n.	尼罗河
east 	n.	东
west 	n.	西
I Broke It		
blaming	v. 	责备；归咎于
fess	v. 	坦白
guilty	adj.	内疚的
punished	v. 	惩罚
shame	n.	羞愧
slumps	v. 	（肩或脑袋）耷拉着
Argentina		
borders 	n.	边界，边境
capital 	n.	首都
control 	n.	控制
crops 	n.	农作物
Europe 	n.	欧洲
wheat 	n.	小麦
population	n.	人口
primary	adj.	主要的，基本的
language	n.	语言
religion 	n.	宗教信仰
currency 	n.	货币
Broken Arm Blues 		
blues 	n.	忧郁，忧伤
bored	adj.	无聊的
bulky	adj.	笨重的
cast	n.	石膏
karate	n.	空手道
pod	n.	豆荚
Baseball		
athlete 	n.	运动员
bases 	n.	垒
batter 	n.	击球手
catcher 	n.	接球手
home runs 	n.	跑垒
pitcher	n.	投球手
famous	adj.	有名的
field	n.	球场
home plate 	n.	本垒，本垒板
brought 	v.	带来（bring的过去式）
Monkey and Crocodile 		
escape	v. 	逃跑
fetch	v. 	取来
guest	n.	客人
invited	v. 	邀请
outsmarted	v. 	比…更聪明
trusted	v. 	信任
ashamed 	adj.	惭愧的
wits	n.	才智
Firefighters 		
firefighters 	n.	消防员
fuel	n.	燃料
machines	n.	机器
pump	n.	泵
spray	v. 	喷射
training	n.	训练
different	adj.	不同的
important	adj.	重要的
protect	v. 	保护
flame	n.	火焰
masks 	n.	面罩
destroy 	v. 	毁坏
Can You Say Pterodactyl 		
creature 	n.	生物
leathery	adj.	坚韧的
murmur	v.	小声说
pronounce	v.	发音
pterodactyl	n.	翼龙
rare	adj.	珍稀的
scrunched 	v.	缩紧；使弯曲
Mexico 		
cactus 	n.	仙人掌
canyons 	n.	峡谷
chile peppers 	n.	智利红辣椒
deserts 	n.	沙漠
fireworks 	n.	烟花
parades 	n.	游行
remember 	v. 	记得
celebrate 	v. 	庆祝
special	adj.	特殊的，特别的
thumb 	n.	大拇指
The Cinnamon Bun Mystery 		
baker	n.	面包师
bakery	n.	面包店
cinnamon	n.	肉桂
bun	n.	面包
scooter	n.	小轮摩托车
usual	n.	惯常的事物
Garrett Morgan and the Traffic Signal 		
busy 	adj.	繁忙的
corners	n.	角落
plan	n.	计划
problems	n.	问题
signal	n.	信号
traffic	n.	车流，人流
buggies	n.	轻便马车
