April Fool's Day		
cultures	n.	文化（复数）
disguise	n.	伪装物
media	n.	媒体（复数）
pranks	n.	玩笑（复数）
traditional	adj.	传统的
victim	n.	受害者
foolery	n.	愚蠢
corporate	adj.	全体的
chaos	n.	混乱
The Legend of the Giant's Causeway		
causeway	n.	堤道
Ireland	n.	爱尔兰
iron	adj.	坚强的
outdone	v.	胜过
Scoland	n.	苏格兰
steady	adj.	沉稳的
cradle	n.	摇篮
remains	n.	遗迹
whimpered	v.	抽泣
leprechauns	n.	小精灵（复数）
bonnet	n.	旧式女帽
trembled	v.	抖动
