The Everglades		
development	n.	发展
ecosystems	n.	生态系统
mild	adj.	温和的
national park	n.	国家公园
roots	n.	根
subtropical	adj.	亚热带的
swamp	n.	沼泽(地)
marsh	n.	湿地
cypress	n.	柏树
Great Land Run		
acres	n.	英亩
boomers	n.	大雄袋鼠（复数）
claim	n.	所有权
stake	v.	拿…冒险
sooners	n.	抢先取得占有权的人
territory	n.	领土
settle	v.	定居
lawman	n.	执法官
reservation	n.	(美国为土著美洲人划出的)保留地
