Blizzards!		
air pressure	n.	气压
biting	adj.	刺骨的
blizzard	n.	暴风雪
frostbite	n.	冻伤
whiteout	n.	（气象）乳白天空
wind chill	n.	风寒
dangerous	adj.	危险的
gales	n.	大风
hurricane	n.	(尤指西大西洋的)飓风
freezing	adj.	极冷的
snowstorm	n.	暴风雪
chilly	adj.	寒冷的
Deep in the Ocean		
adaptable	adj.	能适应的
marine	adj.	海生的
sensors	n.	传感器
species	n.	物种
submersible	n.	潜水器
sulfur	n.	硫黄
oceangraphers	n.	海洋学家（复数）
submarine	n.	潜艇
biology	n.	生物
chemistry	n.	化学
