I Love The Earth		
I	pron.	我
the	art.	这个
Earth	n.	地球
desert	n.	沙漠
hill	n.	小山
mountain	n.	高山
ocean	n.	海洋
Playful Puppy		
a	art.	这个
it	pron.	它
the	art.	这个
let	v.	让
puppy	n.	小狗
It Is Spring		
out	adv.	向外
the	art.	这个
up	adv.	向上
everywhere	pron.	到处
leaves	n.	树叶（复数）
plants	n.	植物（复数）
animals	n.	动物（复数）
Sophie Goes for a Walk		
fresh	adj.	新鲜的
jumpy	adj.	跳跃的
leash	n.	缰绳
mailman	n.	邮递员
sniffs	v.	嗅
steak	n.	牛排
big	adj.	大的
long	adj.	长的
new	adj.	新的
Mixing Colors		
brown	n.	棕色
colors	n.	颜色
mix	v.	混合
orange	n.	橙色
purple	n.	紫色
turn	v.	变成
blue	n.	蓝色
red	n.	红色
yellow	n.	黄色
Stop That Cat		
door	n.	门
fence	n.	栅栏
nap	n.	小睡
past	prep.	路过
yard	n.	庭院
zooms	v.	快速通过（三单）
long	adj.	长的
the	art.	一个
My Brain		
brain	n.	大脑
everything	pron.	每件事
listen	v.	听
talk	v.	谈话
think	v.	思考
use	v.	使用
for	prep.	为了
my	pron.	我的
On The Farm		
a	art.	这个
are	v.	是
in	prep.	在...里面
is	v.	是
on	prep.	在...上面
barn	n.	谷仓
field	n.	田野
hay	n.	干草
mud	n.	泥坑
Near and Far Away		
is	v.	是
that	pron.	那个
this	pron.	这个
far	adj,	远的
near	adj,	近的
Swing, Sydney, Swing!		
besides	prep.	在...旁边
between	prep.	在...中间
chickens	n.	母鸡（复数）
nest	n.	鸟巢
farm	n.	农场
swing	v.	荡秋千
at	prep.	在...处
over	prep.	在...上
under	prep.	在...下面
