The Visual Village		
controversy	n.	争议
democracy	n.	民主
dramatic	adj.	戏剧性的，显著的
embrace	v.	拥抱，接受
instantly	adv.	立即，瞬间
obsessed	adj.	着迷的，困扰的
profound	adj.	深刻的，深远的
relevant	adj.	相关的
represent	v.	代表，表现
tremendous	adj.	巨大的，极大的
My Journey in Photographs		
enrich	v.	丰富，充实
expectation	n.	期望，预期
overcome	v.	克服
portrait	n.	肖像，画像
project	v.	投射，规划
sincere	adj.	真诚的
teamwork	n.	团队合作
thus	adv.	因此
tuition	n.	学费
turn out	v.	证明
Living Light		
astonishing	adj.	令人惊讶的
countless	adj.	无数的
descend	v.	下降，降临
disturb	v.	打扰，扰乱
factor	n.	因素
flash	v./n.	闪光，闪现
invisible	adj.	无形的，看不见的
layer	n.	层
predator	n.	捕食者
transparent	adj.	透明的
Feathers of Love		
absurd	adj.	荒谬的
bounce	v.	跳跃，弹起
breed	v.	繁殖，培育
commence	v.	开始
evolution	n.	进化
harsh	adj.	严酷的，恶劣的
noble	adj.	高贵的
prominently	adv.	显著地，突出地
ritual	n.	仪式，典礼
undergo	v.	经历，遭受
How Safe Is Our Food		
compulsory	adj.	强制的，义务的
confine	v.	限制，禁闭
contaminate	v.	污染
determine	v.	决定，确定
digestion	n.	消化
feasible	adj.	可行的
infect	v.	感染
integral	adj.	必须的，整体的
nationwide	adj./adv.	全国性的，遍及全国
optimistic	adj.	乐观的
The Battle for Biotech		
allergic	adj.	过敏的
alternative	adj./n.	可替代的；替代品
conventional	adj.	传统的，常规的
deficiency	n.	缺乏，缺陷
diminish	v.	减少，缩小
modify	v.	修改，调整
notwithstanding	prep./adv.	尽管
nutritional	adj.	营养的
revolution	n.	革命
trait	n.	特征，特点
Design by Nature, Biomimetics		
biological	adj.	生物的
device	n.	设备，装置
fund	n.	资金
gap	n.	缺口，差距
gradually	adv.	逐渐地
insight	n.	洞察力，见解
nonetheless	adv.	尽管如此
phase	n.	阶段
vertical	adj.	垂直的
vital	adj.	至关重要的
Weaving the Future
appliance	n.	电器，设备
fantasy	n.	幻想
foresee	v.	预见
forthcoming	adj.	即将到来的
fraction	n.	部分，分数
manufacturing	n.	制造业
portable	adj.	便携的
rigid	adj.	僵硬的，严格的
suspend	v.	暂停，悬挂
thereby	adv.	因此，从而
